12 27 1 12 12 31 18 11 21 12 12 10 19 2 10 31 18 18 31 10 20 18 31 1 12 12 10 31 20 31 18 27 20 29 0 0 22 1 20 17 0 0 0 0 23 0 0 0 0 0 
5 27 27 27 12 27 16 0 0 5 12 16 0 0 4 1 27 1 20 27 27 12 27 12 12 27 1 27 12 1 12 20 27 17 0 0 4 12 12 25 0 0 0 0 7 0 0 0 0 0 
13 2 2 21 1 1 17 0 0 22 12 16 0 0 22 1 27 1 1 20 27 1 12 12 20 20 27 20 27 12 27 27 27 17 0 0 4 21 21 16 0 0 0 15 8 0 0 0 0 0 
0 0 0 0 6 21 13 32 11 21 2 16 0 0 5 20 12 20 20 20 12 27 12 27 12 13 21 2 1 12 27 1 12 16 0 0 7 0 0 7 0 0 0 0 23 0 0 0 0 0 
0 0 0 0 0 0 0 0 0 0 0 4 19 19 1 27 12 12 1 1 20 2 21 2 8 0 0 0 28 1 27 27 20 8 0 0 7 0 0 22 18 29 0 0 7 0 0 0 0 0 
0 0 0 0 0 0 0 0 0 9 0 7 0 0 5 1 12 12 20 27 17 0 0 0 23 0 0 0 6 2 21 13 21 16 0 0 28 10 10 27 27 25 0 0 5 31 32 19 11 30 
0 0 0 0 0 0 0 0 0 0 0 23 0 0 5 20 20 27 27 27 16 0 0 0 5 29 0 0 0 0 0 0 0 5 10 10 20 1 27 27 12 27 31 18 20 8 0 0 0 0 
0 0 0 0 0 0 0 0 0 0 14 8 0 0 5 1 20 27 21 2 12 31 31 18 20 16 0 0 0 0 0 0 0 22 13 21 12 12 27 27 12 20 27 12 1 8 0 0 0 0 
0 0 24 0 0 0 0 0 0 14 20 8 0 14 1 13 13 26 0 0 5 1 1 12 12 8 0 0 24 0 0 0 14 8 0 0 4 1 1 12 27 27 1 12 20 17 0 0 0 0 
0 0 23 0 0 24 0 0 14 20 27 25 0 28 25 0 0 0 0 0 28 12 27 20 12 26 0 0 5 18 31 19 2 25 0 0 6 2 2 2 2 21 2 20 12 17 0 0 0 0 
0 0 23 0 15 2 19 11 27 20 27 16 0 4 16 0 0 24 0 0 4 27 1 1 25 0 0 0 22 27 25 0 0 7 0 0 0 0 0 0 0 0 0 22 20 20 30 0 0 0 
0 14 17 0 0 0 0 0 22 2 13 17 0 6 26 0 0 23 0 0 22 12 1 1 8 0 0 0 6 1 8 0 0 7 0 0 0 0 0 0 0 0 0 5 20 17 0 0 0 0 
11 1 8 0 0 15 30 0 7 0 0 7 0 0 0 0 0 28 31 18 1 27 12 12 1 10 29 0 0 22 25 0 0 4 10 18 31 31 18 18 29 0 0 4 27 8 0 0 0 0 
0 22 20 29 0 0 0 0 23 0 0 7 0 0 0 0 0 22 12 27 1 12 12 1 1 1 25 0 0 28 25 0 0 4 27 20 27 20 12 1 16 0 0 28 1 12 31 31 10 31 
0 4 27 17 0 0 0 0 28 31 18 27 10 31 31 18 31 20 12 27 27 20 1 20 1 12 20 18 18 12 12 31 18 20 12 20 1 12 1 20 27 10 31 20 20 12 13 13 2 16 
0 4 12 8 0 0 0 0 4 12 27 27 12 1 1 27 20 20 1 27 27 20 1 2 21 21 27 1 1 1 27 27 1 1 12 1 27 20 12 20 12 1 1 27 12 8 0 0 0 22 
0 22 12 8 0 0 0 0 6 12 27 27 20 27 12 27 12 20 1 12 27 1 17 0 0 0 6 27 1 27 12 27 20 27 1 27 1 12 20 27 1 1 27 20 20 8 0 0 0 6 
0 6 1 17 0 0 0 0 0 28 20 20 27 1 12 12 27 20 12 27 20 27 25 0 0 0 0 28 20 12 27 27 12 12 20 20 12 20 27 20 12 20 1 27 20 16 0 0 0 0 
0 0 6 8 0 0 0 0 0 5 1 12 12 20 20 1 20 12 1 2 21 21 8 0 0 0 0 22 1 2 2 21 21 21 2 21 20 20 12 20 12 1 12 20 12 8 0 0 0 0 
0 0 0 22 29 0 0 0 0 22 27 12 20 27 12 12 27 21 26 0 0 0 28 10 29 0 0 22 17 0 0 0 0 0 0 0 4 12 12 1 27 20 12 20 1 1 18 18 10 32 
0 0 0 28 16 0 0 0 0 28 1 1 20 20 12 12 17 0 0 0 0 0 5 1 1 18 18 20 16 0 0 0 0 0 0 0 6 20 27 12 27 12 20 20 27 1 1 27 25 0 
0 0 0 22 1 18 30 0 0 6 12 27 12 27 27 20 26 0 15 18 18 10 20 1 12 20 20 12 25 0 0 0 0 0 0 0 0 4 27 2 21 12 20 12 20 12 27 27 8 0 
0 0 15 1 20 16 0 0 0 0 28 27 20 27 12 17 0 0 0 4 20 12 12 12 12 27 27 20 27 31 10 10 10 31 29 0 0 5 16 0 0 28 27 27 27 1 12 20 12 32 
0 0 0 22 20 16 0 0 0 0 5 27 12 13 2 8 0 0 0 22 20 20 20 27 12 2 2 27 12 12 12 20 20 20 25 0 0 28 8 0 0 6 12 12 27 12 2 2 25 0 
0 0 0 22 27 20 29 0 0 0 4 27 16 0 0 7 0 0 0 5 27 1 12 13 26 0 0 28 1 20 1 1 20 12 20 18 10 27 25 0 0 0 22 12 1 8 0 0 23 0 
0 0 0 22 27 27 25 0 0 0 5 12 17 0 0 7 0 0 14 27 12 20 8 0 0 0 0 6 20 12 20 27 27 27 20 12 1 12 25 0 0 0 5 1 20 8 0 0 5 18 
0 0 0 22 12 20 12 29 0 0 28 27 20 31 10 20 10 10 27 1 12 27 25 0 0 0 0 0 5 20 12 1 1 1 20 12 12 20 20 31 10 31 27 12 20 12 10 31 27 25 
18 18 10 12 12 20 12 17 0 0 28 20 1 12 20 20 1 1 1 27 13 21 21 32 30 0 0 0 4 1 12 1 27 1 27 1 27 12 2 21 12 12 20 13 2 12 27 12 12 8 
27 20 12 1 20 12 27 27 18 10 12 12 1 27 20 20 27 20 1 16 0 0 0 0 0 0 0 0 4 1 12 12 12 20 1 27 27 26 0 0 6 27 25 0 0 6 13 20 27 27 
12 27 12 27 12 20 27 12 27 20 20 12 12 20 20 20 12 27 1 17 0 0 0 24 0 0 0 0 22 1 20 20 20 1 20 27 17 0 0 0 0 4 25 0 0 0 0 5 27 16 
4 27 20 1 12 1 12 12 1 12 1 1 1 27 27 20 12 12 20 27 18 10 10 21 32 32 11 10 12 20 20 12 27 20 20 20 8 0 0 0 0 28 20 18 29 0 0 5 27 25 
4 27 20 27 1 20 12 1 20 12 20 27 27 27 27 20 12 20 1 27 27 12 8 0 0 0 0 4 12 27 27 12 1 12 12 1 27 30 0 0 0 4 12 1 1 31 31 27 20 12 
4 27 27 27 12 1 1 27 20 20 1 27 12 12 12 20 1 21 13 27 1 1 25 0 0 0 0 22 12 27 12 12 12 20 20 20 16 0 0 0 0 5 12 12 1 27 12 1 20 8 
28 1 12 1 1 27 20 20 27 27 12 27 27 12 1 20 25 0 0 28 27 1 16 0 0 0 0 28 20 1 20 20 1 27 12 20 8 0 0 0 15 13 12 20 12 27 1 12 20 20 
28 1 12 20 1 12 1 20 20 27 20 12 20 12 20 12 16 0 0 5 1 1 20 10 29 0 0 28 27 27 21 2 27 1 12 27 25 0 0 0 0 0 4 12 12 20 12 20 12 25 
28 12 1 27 27 12 20 27 12 12 27 13 2 1 12 27 12 10 18 27 12 12 20 12 16 0 0 5 1 16 0 0 6 2 21 13 20 18 31 29 0 0 4 12 20 12 20 12 1 16 
20 20 27 20 27 20 12 1 1 1 25 0 0 4 1 27 27 1 27 27 27 13 2 13 16 0 15 27 1 26 0 0 0 0 0 0 5 27 12 20 18 31 27 20 1 20 1 1 27 17 
4 1 1 2 13 12 12 12 1 1 25 0 0 5 1 27 27 1 13 21 16 0 0 0 7 0 0 5 17 0 0 0 0 0 0 0 4 12 12 1 12 20 1 27 20 12 20 27 20 20 
4 27 17 0 0 22 12 20 12 12 12 18 10 1 1 12 27 8 0 0 23 0 0 0 6 30 0 22 25 0 0 0 0 0 0 0 5 27 1 1 1 12 1 20 20 1 27 1 27 20 
12 27 8 0 0 28 20 1 1 12 1 27 1 20 27 27 20 17 0 0 23 0 0 0 0 0 0 28 17 0 0 0 0 0 0 0 22 20 27 1 27 1 1 12 20 1 1 12 1 8 
27 12 1 31 18 1 27 2 21 13 1 27 12 12 12 20 27 27 31 31 20 18 10 10 29 0 0 22 2 32 31 31 29 0 0 0 28 27 27 1 20 12 12 1 20 27 20 20 12 16 
5 12 27 27 12 12 25 0 0 0 5 20 12 27 12 20 27 27 1 1 1 20 1 20 8 0 0 23 0 0 4 12 16 0 0 0 22 27 1 1 27 12 13 2 13 2 1 1 20 8 
1 27 1 2 2 27 26 0 0 0 22 20 12 1 20 1 20 27 12 27 20 20 27 27 27 31 31 8 0 0 22 20 27 18 10 10 1 27 1 20 20 8 0 0 0 0 4 1 12 8 
13 21 26 0 0 7 0 0 0 0 5 1 12 12 27 1 27 12 12 1 20 20 1 12 1 27 20 27 31 31 27 12 1 1 27 12 20 12 20 20 27 8 0 0 0 0 4 1 27 2 
0 0 0 0 0 7 0 0 0 0 28 20 12 27 12 12 12 1 13 2 1 20 1 12 1 12 12 20 1 1 20 1 1 27 12 1 20 20 20 20 20 21 30 0 0 0 22 27 26 0 
0 0 0 0 0 6 11 32 19 18 27 27 12 20 1 12 1 8 0 0 6 12 20 12 12 27 1 1 20 12 1 1 20 27 12 20 1 20 12 27 25 0 0 0 0 0 28 16 0 0 
0 0 0 0 0 0 0 0 0 6 2 13 20 20 12 27 12 16 0 0 0 28 20 12 1 27 12 27 1 12 12 12 1 12 27 1 1 20 20 27 8 0 0 0 0 0 5 16 0 0 
0 0 0 0 0 0 0 0 0 0 0 0 4 27 13 21 27 8 0 0 0 4 1 20 20 1 27 12 27 20 12 12 1 1 12 27 27 27 1 20 8 0 0 0 0 0 28 20 18 31 
0 0 0 0 0 0 0 0 0 0 0 0 5 25 0 0 5 25 0 0 0 28 20 27 20 27 27 1 20 12 27 12 1 20 27 1 1 27 12 12 25 0 0 0 0 0 28 20 20 8 
0 0 0 0 0 0 0 0 0 0 0 0 22 25 0 0 4 27 31 18 19 2 27 20 20 20 1 13 1 1 13 13 1 20 13 12 12 27 1 27 26 0 0 0 0 0 5 13 12 25 