0 0 0 0 0 0 0 0 0 0 0 0 0 0 0 0 0 0 0 4 17 0 0 0 0 0 0 14 18 12 10 29 0 0 0 0 0 0 0 0 6 19 1 21 18 25 0 28 10 16 
0 0 0 0 0 0 0 0 0 0 0 0 0 0 0 0 0 0 0 5 27 30 0 0 0 0 14 27 1 1 2 12 29 0 0 0 0 0 0 0 0 0 23 0 5 1 10 2 1 16 
0 0 0 0 0 0 0 0 0 0 0 0 0 0 0 0 0 0 0 5 16 0 0 0 24 0 22 3 20 8 0 4 16 0 0 24 0 0 0 14 29 0 5 31 2 20 25 0 22 3 
0 0 0 0 0 0 0 0 0 0 0 0 0 0 0 0 0 0 0 22 21 32 11 11 17 0 4 13 1 20 32 2 1 31 10 12 29 0 0 28 20 10 13 25 0 4 25 0 4 8 
0 0 0 0 0 0 0 0 0 0 0 0 0 0 0 0 0 0 0 7 0 0 0 0 5 19 16 0 22 26 0 0 6 21 27 1 3 11 11 1 13 16 0 22 19 12 20 18 20 17 
0 0 0 0 0 0 0 0 0 0 0 0 0 0 0 0 0 0 0 23 0 0 14 10 17 0 23 0 23 0 0 0 0 0 6 12 25 0 0 23 0 4 18 16 0 4 12 2 21 8 
0 0 0 0 0 0 0 0 0 0 0 0 0 0 0 0 0 0 0 22 29 0 4 27 16 0 5 18 3 10 29 0 0 0 0 5 20 10 18 16 0 28 13 13 31 3 25 0 0 22 
11 32 29 0 0 0 9 0 0 0 0 0 0 0 0 0 0 0 0 22 12 18 13 21 17 0 4 21 13 21 2 19 19 11 11 13 21 27 13 12 19 16 0 0 5 27 20 10 11 26 
0 0 23 0 0 0 0 0 0 0 0 0 0 0 0 0 0 0 0 6 20 17 0 0 4 31 17 0 0 0 0 0 0 0 0 0 0 7 0 7 0 7 0 0 6 20 20 8 0 0 
18 10 16 0 0 0 0 0 0 0 0 24 0 0 0 0 0 0 0 0 22 27 18 10 2 13 25 0 0 0 0 0 0 0 0 0 0 22 18 20 32 17 0 0 0 4 1 17 0 0 
3 12 16 0 0 0 0 0 0 0 0 7 0 0 0 0 0 0 0 0 4 21 27 8 0 0 22 29 0 0 0 0 0 0 0 0 0 6 13 16 0 7 0 15 19 2 2 2 31 29 
12 3 8 0 0 0 0 0 0 0 0 5 31 31 32 31 11 30 0 0 23 0 28 21 30 0 4 20 19 29 0 0 0 0 0 0 0 0 0 5 18 16 0 0 0 0 0 0 4 27 
3 3 16 0 0 0 24 0 0 0 0 5 1 17 0 7 0 0 0 0 22 11 25 0 0 14 20 8 0 7 0 14 18 29 0 0 0 0 15 20 13 8 0 0 0 0 0 15 12 20 
28 12 25 0 14 18 8 0 0 0 0 22 12 12 32 17 0 0 0 0 7 0 5 19 31 21 12 8 0 4 18 1 27 17 0 0 0 0 0 7 0 28 10 29 0 0 0 0 4 3 
20 1 1 19 3 1 8 0 0 0 0 28 21 26 0 4 10 30 0 0 22 31 16 0 7 0 4 13 32 27 12 12 12 20 11 19 19 29 0 4 32 2 3 27 10 10 18 11 1 1 
27 20 8 0 28 27 8 0 0 0 0 23 0 0 0 22 17 0 0 0 22 21 16 0 4 32 17 0 0 6 1 3 12 16 0 0 0 22 31 16 0 0 28 13 27 3 8 0 5 13 
28 27 17 0 22 12 26 0 0 0 0 7 0 0 0 22 26 0 0 0 23 0 5 10 16 0 7 0 0 0 22 20 12 17 0 0 0 5 2 21 19 18 16 0 22 12 2 32 17 0 
28 2 3 18 20 25 0 0 0 0 0 5 30 0 0 7 0 0 0 0 7 0 5 27 17 0 7 0 0 0 6 3 12 26 0 15 18 17 0 0 0 28 25 0 28 16 0 0 23 0 
8 0 4 20 3 25 0 0 0 0 0 23 0 0 0 5 30 0 0 0 28 19 21 2 1 32 16 0 24 0 0 22 16 0 0 0 22 17 0 0 0 22 21 19 27 12 31 11 26 0 
4 31 20 2 1 16 0 0 0 0 15 16 0 15 10 25 0 0 0 0 23 0 0 0 23 0 23 0 28 30 0 28 20 10 18 11 13 8 0 0 0 7 0 0 4 12 16 0 0 0 
22 3 17 0 28 16 0 0 0 0 0 7 0 0 28 26 0 0 0 0 28 10 11 19 21 18 27 18 25 0 14 1 1 21 25 0 0 23 0 0 0 23 0 0 4 20 25 0 0 0 
3 1 13 18 27 26 0 0 14 18 10 3 19 11 26 0 0 0 0 0 28 16 0 0 0 5 3 13 25 0 6 1 16 0 28 19 10 3 32 11 32 2 31 18 3 12 25 0 0 0 
6 25 0 5 25 0 0 14 13 3 1 16 0 0 0 14 10 29 0 0 6 21 32 11 32 27 25 0 28 29 0 22 17 0 7 0 4 25 0 0 0 0 4 1 12 12 25 0 0 0 
0 4 19 2 26 0 0 23 0 5 27 27 11 11 31 20 12 25 0 0 0 0 0 0 0 5 3 11 12 3 32 27 12 31 8 0 6 3 18 18 19 31 20 1 21 27 25 0 0 0 
0 7 0 0 0 0 0 6 18 3 3 25 0 0 28 27 3 16 0 0 0 0 0 0 0 5 16 0 5 16 0 22 20 12 3 29 0 5 1 17 0 4 2 8 0 4 25 0 0 0 
14 25 0 0 0 0 0 0 4 20 27 8 0 0 5 1 1 26 0 0 0 0 0 0 0 6 17 0 28 21 11 13 13 3 12 1 18 3 1 12 10 17 0 4 18 3 25 0 0 0 
2 2 31 10 19 31 31 32 3 12 12 17 0 0 28 1 25 0 0 0 0 0 0 0 0 0 4 11 26 0 0 0 0 4 21 21 13 27 3 1 1 16 0 5 20 3 25 0 0 0 
0 0 28 25 0 5 17 0 5 1 2 26 0 0 4 27 1 32 10 30 0 0 0 0 0 0 23 0 0 0 0 0 0 7 0 0 0 6 12 2 27 26 0 5 3 3 8 0 0 0 
0 0 5 20 18 3 2 11 27 8 0 0 0 0 4 12 17 0 23 0 0 0 0 0 0 0 22 10 30 0 0 0 0 23 0 0 0 0 23 0 7 0 14 13 2 2 27 18 10 10 
0 0 22 12 20 26 0 0 5 25 0 0 0 0 22 20 12 19 27 10 18 32 30 0 0 0 5 8 0 0 0 14 10 26 0 0 0 14 20 19 12 32 16 0 0 0 28 27 3 26 
0 0 4 12 16 0 0 0 5 17 0 0 0 0 4 3 25 0 22 27 25 0 0 0 0 0 22 27 32 10 31 27 16 0 0 0 14 1 16 0 7 0 6 19 11 31 3 1 26 0 
32 11 2 2 1 18 11 11 21 25 0 0 0 0 4 1 12 31 20 20 26 0 0 0 0 0 4 8 0 6 21 2 16 0 0 0 22 12 8 0 23 0 0 0 0 22 27 8 0 0 
0 0 0 0 22 17 0 0 0 23 0 0 0 15 13 13 13 27 1 8 0 0 0 0 0 0 4 26 0 0 0 0 7 0 15 32 13 20 27 18 17 0 0 24 0 6 20 16 0 0 
0 0 0 15 21 3 31 10 32 26 0 0 0 0 0 0 0 5 27 20 10 18 29 0 0 0 23 0 0 24 0 0 23 0 0 0 0 22 1 20 25 0 0 23 0 0 22 25 0 0 
0 0 0 0 0 28 20 16 0 0 0 0 0 0 0 0 0 5 27 13 2 20 1 19 10 11 26 0 14 12 10 19 17 0 0 15 32 13 21 20 27 10 31 1 10 10 27 25 0 0 
0 0 0 0 0 4 20 25 0 0 0 14 10 32 32 11 10 13 17 0 0 4 16 0 7 0 0 0 4 12 25 0 23 0 0 0 0 0 0 22 27 1 1 21 12 2 27 8 0 0 
19 10 19 19 11 27 20 20 31 30 0 4 26 0 0 0 7 0 28 30 0 28 3 19 13 19 11 11 2 12 25 0 7 0 0 14 31 10 10 20 20 21 16 0 23 0 28 16 0 0 
0 7 0 0 0 4 13 3 16 0 0 7 0 0 0 14 3 18 8 0 0 22 16 0 0 0 0 0 0 6 16 0 23 0 14 27 12 3 20 13 26 0 28 31 3 10 3 25 0 0 
10 13 19 31 10 16 0 22 8 0 0 7 0 0 0 22 12 1 8 0 0 22 3 11 10 31 10 29 0 0 6 32 21 19 12 20 12 1 17 0 0 0 6 1 21 1 13 8 0 0 
23 0 0 6 12 12 18 1 16 0 15 25 0 0 0 4 3 12 20 10 11 2 25 0 4 27 3 25 0 0 0 0 0 0 4 1 3 20 8 0 0 0 0 7 0 7 0 7 0 0 
17 0 0 0 22 1 27 27 25 0 0 23 0 0 0 22 2 21 12 17 0 0 7 0 6 12 27 21 18 10 10 29 0 0 28 20 1 12 26 0 0 0 14 8 0 23 0 7 0 0 
25 0 0 0 6 13 12 12 12 18 10 17 0 0 0 23 0 0 5 17 0 0 23 0 0 5 17 0 4 3 20 1 10 18 12 13 27 17 0 0 0 14 27 8 0 28 18 8 0 0 
17 0 0 0 0 0 4 13 20 2 27 25 0 0 0 4 29 0 5 3 10 10 8 0 0 4 17 0 4 12 12 13 13 20 8 0 28 25 0 0 0 28 27 8 0 5 1 17 0 0 
8 0 0 0 0 0 23 0 7 0 28 3 31 31 31 12 2 18 20 3 27 12 27 19 32 12 12 10 20 12 17 0 0 28 3 32 3 25 0 24 0 4 2 12 31 13 13 13 30 0 
21 11 29 0 0 0 22 31 12 10 20 20 21 1 27 25 0 6 13 12 20 27 8 0 0 22 1 1 12 27 13 10 19 12 16 0 28 1 19 12 32 16 0 4 17 0 0 0 0 0 
0 0 28 11 10 32 1 27 1 3 1 26 0 28 1 17 0 0 0 28 12 27 25 0 0 28 3 27 1 26 0 7 0 4 21 11 21 25 0 7 0 7 0 22 16 0 0 0 0 0 
19 31 25 0 7 0 28 20 12 1 25 0 0 4 1 13 10 18 10 3 3 3 27 10 18 2 20 3 25 0 14 1 11 16 0 0 0 6 11 20 10 21 32 2 8 0 0 0 0 0 
0 6 26 0 6 32 2 13 27 1 8 0 0 22 16 0 5 20 1 13 12 13 27 20 16 0 5 1 2 10 3 17 0 4 11 30 0 0 0 4 8 0 0 0 7 0 0 0 0 0 
0 0 0 0 0 0 0 0 22 20 3 11 19 12 12 31 2 13 25 0 7 0 4 3 20 11 13 17 0 6 3 3 10 26 0 0 0 0 0 28 27 31 18 10 21 32 10 18 32 18 
0 0 0 0 0 0 0 0 22 1 17 0 0 28 2 25 0 0 7 0 6 32 21 3 26 0 0 22 30 0 28 12 25 0 0 0 0 0 0 5 12 12 2 17 0 0 22 17 0 7 