0 0 0 0 0 0 0 0 0 28 10 29 0 0 0 15 27 27 10 31 1 27 18 20 27 1 10 31 18 27 20 10 18 27 12 1 10 10 27 32 21 30 0 0 0 28 20 12 29 0 
0 0 0 0 0 0 0 0 0 6 21 13 19 29 0 0 28 12 20 12 27 12 20 1 20 12 12 20 27 12 27 12 20 27 1 12 12 20 17 0 0 0 0 0 0 5 12 27 27 19 
0 0 0 0 0 0 0 0 0 0 0 0 0 23 0 0 5 20 1 1 27 20 27 12 27 27 20 20 12 12 12 27 27 27 12 20 27 27 27 29 0 0 0 14 11 13 21 13 26 0 
0 0 0 0 0 0 0 0 0 0 0 0 14 8 0 0 22 20 1 1 20 12 1 20 1 1 12 12 27 1 27 27 1 27 27 1 27 20 2 13 19 11 11 26 0 0 0 0 0 0 
0 0 0 0 0 0 0 0 0 24 0 0 28 25 0 14 12 1 12 12 20 27 12 20 12 27 12 27 12 12 12 20 12 20 13 2 21 17 0 0 0 0 0 0 0 0 0 0 0 0 
0 0 0 0 0 0 0 0 0 28 19 19 2 2 19 2 12 1 27 27 27 20 27 12 27 20 27 20 27 20 1 27 20 8 0 0 0 4 29 0 0 0 0 0 0 0 0 0 0 0 
0 0 0 0 0 0 0 0 0 7 0 0 0 0 0 0 6 2 1 27 20 12 12 27 12 27 12 1 20 20 27 27 1 1 31 10 18 1 8 0 0 0 0 0 0 0 0 0 0 0 
0 0 0 0 0 0 0 0 14 16 0 0 0 0 0 24 0 0 22 27 27 12 27 1 27 1 20 1 20 1 27 27 27 13 2 27 12 12 12 30 0 0 0 0 0 0 0 0 0 0 
0 0 0 0 0 0 0 0 28 16 0 0 0 0 14 1 32 10 20 12 27 12 27 12 12 27 12 20 27 1 12 12 8 0 0 22 12 2 26 0 0 0 0 0 0 0 0 0 0 0 
0 0 0 0 0 0 0 0 4 25 0 0 0 0 28 8 0 6 20 27 1 1 20 27 20 1 1 27 20 1 13 20 21 19 32 2 8 0 0 0 0 0 0 0 0 0 0 0 0 0 
0 0 14 30 0 0 0 0 22 1 11 19 19 19 27 25 0 0 28 27 27 20 12 20 1 12 1 12 1 16 0 7 0 0 0 0 4 18 30 0 0 0 0 0 0 14 29 0 0 0 
0 15 25 0 0 0 0 0 28 17 0 0 0 0 6 17 0 0 22 1 27 12 20 20 20 12 12 27 27 16 0 5 29 0 14 32 20 17 0 0 0 0 24 0 14 21 12 18 31 29 
29 0 7 0 0 0 0 14 1 16 0 0 0 0 0 4 11 11 12 27 20 20 12 20 27 27 12 20 1 12 11 2 27 32 26 0 4 1 18 19 19 32 21 32 26 0 5 12 20 12 
25 0 28 11 10 10 10 27 1 17 0 0 0 0 0 23 0 0 22 12 12 12 20 12 20 20 20 1 20 8 0 0 23 0 0 0 4 1 8 0 0 0 0 0 0 0 28 12 1 25 
4 31 17 0 28 2 2 20 1 25 0 14 11 18 10 8 0 0 22 20 20 12 27 12 27 20 27 20 12 20 18 31 8 0 0 0 22 13 21 32 32 19 32 32 32 18 1 1 13 27 
6 21 25 0 7 0 0 28 2 13 10 17 0 28 1 27 18 18 20 1 1 12 1 1 12 27 27 13 2 1 1 20 2 19 30 0 23 0 0 0 0 0 0 0 0 4 27 26 0 23 
0 0 22 10 1 10 18 26 0 0 4 16 0 4 1 20 12 20 12 27 27 21 1 20 1 20 17 0 0 4 27 26 0 0 0 0 6 30 0 0 0 0 0 0 0 4 16 0 0 6 
0 0 4 12 21 20 17 0 0 15 13 2 11 2 20 27 1 27 20 27 16 0 4 1 1 27 27 18 31 2 8 0 0 0 0 0 0 0 0 0 0 0 0 0 0 6 20 10 29 0 
0 0 28 16 0 28 20 29 0 0 0 0 0 0 28 27 27 1 12 12 12 10 1 12 1 27 27 12 25 0 28 31 31 19 19 18 29 0 0 0 0 0 0 0 0 0 5 1 21 31 
15 11 2 17 0 28 20 20 30 0 0 0 0 14 20 12 20 27 20 12 27 27 27 27 1 1 12 27 8 0 22 12 16 0 0 6 1 31 29 0 0 0 0 0 0 0 5 25 0 28 
0 0 0 5 18 21 1 25 0 0 14 31 31 12 20 27 12 12 20 12 12 12 27 1 20 12 20 12 12 10 27 20 17 0 0 0 5 20 16 0 0 0 0 0 0 0 5 8 0 28 
0 0 0 22 8 0 5 20 31 32 2 27 27 20 20 20 27 12 1 1 1 1 12 27 20 20 27 12 1 1 1 13 8 0 0 0 5 20 16 0 0 0 0 0 0 0 4 25 0 28 
0 0 0 4 17 0 28 1 16 0 0 22 20 12 27 1 1 12 20 27 12 20 27 12 21 2 12 1 20 27 8 0 4 30 0 0 6 2 13 10 30 0 0 0 0 0 22 21 19 13 
0 0 0 6 13 32 21 21 25 0 0 28 20 27 20 12 27 27 20 1 12 12 20 8 0 0 6 21 20 20 16 0 7 0 0 0 0 0 0 7 0 0 0 0 0 0 7 0 0 0 
0 0 0 0 0 0 0 0 4 18 18 20 20 27 12 20 1 27 20 27 12 1 27 16 0 0 0 0 28 12 8 0 23 0 0 0 0 0 0 7 0 0 0 0 0 0 23 0 0 0 
0 0 0 0 0 0 0 0 4 13 12 20 1 27 12 1 1 1 1 27 20 1 27 1 31 29 0 0 4 20 20 31 13 11 32 10 31 10 10 20 30 0 0 0 0 0 28 31 18 11 
0 0 0 0 0 0 0 0 7 0 4 12 1 20 1 27 1 12 12 20 27 27 1 20 1 17 0 0 28 12 13 26 0 0 0 22 27 27 12 17 0 0 0 0 0 0 6 13 8 0 
0 0 0 0 0 0 0 0 23 0 22 20 1 12 12 1 27 20 12 12 1 20 12 20 27 8 0 0 28 17 0 0 0 0 0 5 27 27 20 1 31 19 19 29 0 0 0 0 7 0 
0 0 0 0 0 0 0 0 5 31 12 12 27 20 20 12 1 27 27 20 12 12 20 12 1 25 0 0 4 1 29 0 0 0 0 4 1 27 1 12 8 0 0 5 10 18 29 0 23 0 
0 0 0 0 0 0 0 15 27 1 1 12 20 20 20 1 27 27 27 12 1 27 27 20 27 13 19 11 1 12 17 0 0 24 0 22 12 27 20 20 1 10 31 27 20 12 21 19 2 10 
0 0 0 0 0 0 0 0 6 12 12 27 1 12 1 1 27 12 27 27 12 27 12 12 17 0 0 0 4 27 1 10 31 1 18 27 27 12 12 20 12 27 27 1 27 25 0 0 0 23 
0 0 0 0 0 9 0 0 0 6 12 1 27 27 12 12 12 20 21 12 27 12 21 12 17 0 14 31 1 27 2 21 2 27 20 12 20 12 12 12 1 12 12 20 27 17 0 0 0 5 
0 0 0 0 0 0 0 0 0 0 28 27 20 12 20 12 12 26 0 4 1 16 0 5 20 10 20 2 20 8 0 0 0 4 1 27 27 20 12 12 12 12 1 1 27 25 0 0 0 28 
0 0 0 0 0 0 0 0 15 10 27 1 12 20 1 12 17 0 0 28 12 26 0 6 1 12 26 0 5 21 32 10 31 20 12 1 20 1 12 27 12 27 27 1 1 27 19 30 0 22 
0 0 0 0 0 0 0 0 0 5 12 20 1 12 12 27 27 18 18 27 8 0 0 0 4 16 0 0 23 0 0 22 27 20 27 27 20 27 1 20 1 20 20 12 1 26 0 0 15 20 
29 0 0 0 0 0 0 0 0 22 21 1 1 20 20 20 12 27 20 1 16 0 0 15 2 25 0 14 26 0 14 20 12 12 1 12 12 12 20 12 12 1 27 27 8 0 0 0 0 5 
8 0 0 0 0 0 0 0 15 8 0 5 20 12 1 12 1 1 27 2 26 0 0 0 0 22 19 8 0 0 22 13 27 12 13 13 1 12 1 1 20 20 1 12 8 0 0 0 0 4 
23 0 0 0 0 0 0 0 0 7 0 22 1 12 27 12 20 20 17 0 0 0 0 0 0 7 0 22 10 31 26 0 5 16 0 0 28 12 12 20 20 1 20 1 20 31 10 18 32 12 
7 0 0 0 0 0 0 0 0 22 18 1 27 1 1 12 12 12 27 31 31 31 10 10 19 26 0 28 21 16 0 0 28 17 0 0 4 12 1 1 12 20 20 20 20 27 27 8 0 4 
26 0 0 0 0 0 0 0 0 4 1 27 12 27 27 1 27 12 12 2 2 21 1 16 0 0 0 7 0 7 0 0 6 13 29 0 28 20 27 1 1 27 2 21 27 12 20 17 0 28 
0 0 0 0 0 0 0 0 0 28 27 20 20 1 20 27 2 13 17 0 0 0 4 16 0 0 0 7 0 4 18 29 0 0 6 19 27 20 13 27 1 17 0 0 28 27 20 26 0 7 
0 0 0 0 0 0 0 0 0 6 21 13 12 20 27 25 0 0 7 0 0 0 6 17 0 0 0 28 31 2 12 20 10 30 0 0 6 8 0 28 20 8 0 0 5 27 8 0 0 23 
0 0 0 0 0 0 0 0 0 0 0 0 28 1 27 20 30 0 28 31 31 29 0 5 10 18 10 2 26 0 22 1 16 0 0 0 0 7 0 5 27 20 29 0 4 21 26 0 0 4 
0 0 0 0 0 0 0 0 0 0 0 0 6 27 13 26 0 0 5 27 27 16 0 4 21 13 25 0 0 0 5 27 12 31 18 18 31 8 0 5 1 12 12 18 25 0 0 0 0 23 
0 0 0 0 0 0 0 0 0 0 0 0 0 23 0 0 0 0 22 1 1 12 31 25 0 0 4 10 30 0 4 20 12 1 27 27 27 1 10 1 20 1 1 20 12 10 10 19 19 25 
0 0 0 0 0 0 0 0 0 0 0 0 0 6 18 32 19 19 2 21 1 12 12 17 0 0 4 26 0 0 6 1 1 1 21 13 13 12 1 20 1 20 1 20 12 20 17 0 0 23 
0 0 0 0 0 0 0 0 0 0 0 0 0 0 23 0 0 0 0 0 28 1 27 2 11 11 16 0 0 0 0 4 12 25 0 0 0 28 1 27 12 27 20 27 20 1 17 0 0 23 
0 0 0 0 0 0 0 0 0 0 0 0 0 0 5 29 0 0 0 0 5 12 26 0 0 0 22 10 31 10 18 12 1 27 11 32 11 21 2 21 21 20 1 1 1 1 12 10 11 27 
18 10 10 29 0 0 0 0 0 0 0 0 0 0 28 25 0 0 0 0 28 26 0 0 0 0 28 12 27 20 12 1 12 25 0 0 0 0 0 0 0 22 1 27 12 27 27 17 0 28 
6 2 2 16 0 0 0 0 0 0 0 0 0 0 6 17 0 0 0 0 7 0 0 0 0 0 5 2 21 27 12 1 21 20 19 11 29 0 0 0 0 22 27 21 21 27 2 17 0 4 