4 12 18 17 0 0 0 5 18 1 12 12 10 20 1 12 12 20 12 1 27 20 1 27 12 
28 27 21 26 0 0 0 5 12 12 21 2 12 20 20 12 1 1 12 12 12 20 20 20 16 
22 8 0 0 0 0 0 5 27 25 0 0 28 27 12 12 1 12 12 27 27 20 1 27 8 
27 16 0 0 0 0 14 20 27 17 0 0 22 20 1 12 20 27 27 1 20 1 27 13 21 
27 25 0 0 0 0 22 1 13 21 31 31 12 1 27 27 20 27 1 12 1 27 16 0 0 
22 8 0 0 0 0 28 25 0 0 5 12 27 27 20 27 1 20 20 20 27 1 17 0 0 
22 25 0 0 0 0 22 26 0 0 4 12 12 27 27 27 1 12 12 12 20 1 25 0 0 
13 26 0 15 31 10 25 0 0 0 5 1 12 1 12 27 1 27 12 1 20 21 26 0 0 
0 0 0 0 4 27 17 0 0 0 28 12 20 1 1 1 21 13 21 12 8 0 0 0 0 
0 0 0 0 5 27 27 18 18 10 20 1 27 12 20 25 0 0 0 6 26 0 0 0 0 
0 0 0 0 4 1 20 1 27 1 20 20 20 1 20 16 0 0 0 0 0 0 0 0 0 
0 14 10 10 1 1 27 1 20 27 1 27 27 12 20 26 0 0 0 0 0 0 0 0 0 
0 4 1 12 12 12 1 1 27 27 1 12 1 20 16 0 0 0 0 0 0 15 31 10 10 
31 12 1 1 27 27 27 1 27 20 20 12 20 12 17 0 0 0 0 0 0 0 5 12 25 
27 20 20 20 20 12 27 20 12 12 20 21 13 12 12 18 29 0 0 0 0 0 28 1 17 
1 20 12 13 21 13 12 1 1 1 16 0 0 28 1 20 17 0 0 0 0 0 4 12 1 
1 27 17 0 0 0 6 1 12 12 8 0 0 4 27 1 8 0 0 0 0 0 28 1 12 
12 12 16 0 0 0 0 22 1 27 20 10 10 27 1 2 2 31 10 31 31 18 20 12 25 
20 12 8 0 0 0 0 4 12 13 21 12 1 1 25 0 0 28 1 20 1 12 12 20 20 
27 20 20 18 18 18 18 12 8 0 0 28 20 20 8 0 0 5 1 20 12 20 12 27 1 
1 1 1 1 20 12 12 12 8 0 0 6 27 27 12 18 31 27 20 27 27 20 12 12 27 
20 27 27 12 1 12 27 1 16 0 0 0 4 20 1 1 1 1 20 1 27 12 1 20 25 
4 27 1 1 27 1 1 27 8 0 0 0 28 27 1 12 12 20 12 12 27 27 20 12 25 
5 12 27 27 1 12 20 12 12 31 31 31 27 1 20 1 27 12 20 12 20 20 20 20 20 
1 12 21 1 13 27 12 1 1 13 13 13 12 12 21 13 27 13 20 20 13 2 21 27 16 