2 2 2 2 2 2 2 2 2 2 2 1 1 1 1 1 1 1 1 1 1 1 6 0 0 0 0 6 0 0 0 5 5 5 5 0 5 5 5 1 5 5 5 6 0 1 2 2 2 2 
2 2 2 2 2 2 2 2 2 2 2 1 1 1 2 2 2 2 2 2 2 2 1 6 4 6 5 1 1 5 5 6 5 5 5 3 5 5 5 5 5 5 5 6 3 1 2 2 2 2 
2 2 2 2 2 2 2 2 2 2 2 2 2 2 2 2 2 2 2 2 2 2 2 5 6 7 6 6 1 1 5 5 5 5 5 5 5 5 5 5 3 5 1 5 5 5 1 5 5 5 
1 2 2 2 2 2 2 2 2 2 2 2 2 5 5 5 1 2 2 2 2 2 2 5 5 6 7 6 6 1 0 1 1 5 5 1 1 5 5 6 1 5 1 1 5 1 1 6 1 1 
1 1 2 2 2 2 2 2 2 2 2 2 2 1 5 5 1 2 2 2 2 2 2 5 5 5 6 7 7 6 0 6 5 5 5 1 5 6 5 6 3 5 1 5 5 1 1 0 5 1 
1 5 1 1 2 2 2 2 2 2 2 2 2 2 1 5 1 1 2 2 2 2 2 1 5 5 0 6 7 6 0 0 5 1 5 5 6 0 1 0 3 1 1 1 5 5 1 0 5 1 
1 5 5 5 1 2 2 2 2 2 2 2 2 2 1 6 1 1 2 2 2 2 2 5 5 1 3 5 6 6 0 0 5 6 5 1 0 3 1 0 0 0 6 0 6 1 1 0 1 1 
1 5 5 5 5 5 1 2 2 2 2 2 2 2 2 1 1 1 1 2 2 2 2 1 1 1 3 5 6 0 6 0 6 7 6 0 6 6 1 0 0 3 6 6 4 6 0 6 6 0 
5 5 5 5 1 1 1 1 1 1 2 2 2 2 2 1 1 1 1 2 2 1 2 2 2 1 1 0 0 6 0 0 6 6 0 0 0 0 0 0 0 6 6 7 6 6 0 4 6 0 
1 0 3 6 5 1 1 1 5 5 5 2 2 2 2 2 1 1 1 2 2 2 2 2 2 2 1 6 0 0 0 0 5 5 0 6 0 0 0 0 6 0 6 7 6 0 6 0 4 0 
0 0 5 5 1 0 0 5 5 5 1 2 2 2 2 2 2 2 1 2 2 2 2 2 2 2 1 6 0 0 0 3 5 5 5 3 3 3 3 5 0 6 7 7 6 6 0 0 6 0 
0 4 6 5 1 5 0 1 1 5 5 1 2 2 2 2 2 2 2 2 2 1 2 1 1 2 5 0 0 0 0 3 5 5 5 5 5 5 5 5 3 5 6 6 1 1 0 0 0 0 
0 0 5 5 3 1 1 1 5 5 5 1 1 2 2 2 2 2 2 2 2 2 2 2 1 2 5 6 3 5 3 3 5 5 5 5 1 1 5 5 5 6 6 5 5 5 0 0 0 0 
0 0 0 5 5 5 5 1 5 5 5 5 1 2 2 2 2 2 2 2 2 2 2 2 2 2 5 1 0 1 0 0 5 5 5 6 0 1 5 5 5 6 7 6 5 5 5 5 0 0 
5 6 5 5 5 5 5 1 1 5 5 1 1 2 2 2 2 2 2 1 2 2 2 2 2 2 5 5 5 5 0 0 5 1 1 0 0 0 3 5 5 5 6 0 6 5 5 6 0 0 
5 6 0 0 6 6 6 1 6 6 1 2 2 2 2 2 2 2 2 1 2 2 2 2 2 2 5 3 5 5 5 0 1 1 5 6 0 0 0 0 0 0 6 0 0 5 5 5 3 3 
6 7 6 0 0 0 0 0 0 1 1 2 2 2 1 2 2 2 2 2 2 2 2 2 2 2 1 1 5 6 5 5 1 2 5 5 6 5 5 5 5 5 1 6 3 1 1 5 6 0 
0 6 0 0 5 0 0 0 0 0 1 1 2 2 1 1 2 2 2 2 2 2 2 2 2 1 1 5 5 6 6 5 1 2 1 1 5 6 6 0 5 5 1 6 0 0 0 0 6 0 
0 0 6 0 0 0 5 0 3 6 6 1 2 2 2 1 2 2 2 2 2 2 2 2 2 2 1 5 1 3 3 5 6 5 5 1 1 1 1 0 6 5 5 5 5 5 1 1 6 6 
0 5 5 5 0 0 1 0 0 0 0 3 1 2 2 2 2 2 2 2 2 2 2 2 1 2 1 5 1 6 5 6 0 5 1 1 5 5 1 0 5 5 1 1 5 6 0 0 0 4 
0 5 1 5 6 3 5 5 5 5 5 5 1 2 2 2 2 2 2 2 2 2 2 2 2 2 1 5 0 6 5 0 0 5 5 5 5 6 5 0 1 1 2 2 1 5 1 0 6 6 
3 5 1 1 1 3 5 0 5 5 5 5 1 2 2 2 2 2 2 2 2 2 2 2 2 1 5 5 0 6 5 5 6 0 5 5 6 7 6 0 5 1 1 2 1 6 0 0 6 6 
5 5 5 1 1 5 5 6 0 1 1 5 1 2 2 2 2 2 2 2 2 2 2 2 1 1 1 0 0 6 5 5 6 0 3 6 0 6 0 0 1 1 1 2 2 1 5 1 0 0 
5 5 1 1 1 1 5 5 5 5 5 5 3 1 2 2 2 2 2 2 2 2 2 2 1 1 1 1 0 6 6 5 1 0 0 0 4 0 0 0 5 6 1 1 2 2 5 5 0 0 
6 1 1 1 1 5 5 5 5 5 5 1 1 1 2 2 2 2 2 2 2 2 1 5 1 2 2 1 3 1 1 1 1 3 6 0 0 0 0 0 0 0 0 0 5 5 5 5 0 0 
3 1 1 5 5 5 5 5 5 5 5 1 1 1 2 2 2 2 2 2 2 1 5 1 2 2 2 1 1 2 1 5 5 1 0 0 0 0 0 0 6 0 0 0 5 1 1 1 6 6 
0 0 5 5 5 5 5 5 5 5 5 1 2 1 2 2 2 2 2 2 2 1 5 2 2 2 2 1 5 2 1 5 5 5 5 6 0 6 0 6 0 5 6 0 0 0 6 1 1 1 
5 5 5 5 6 5 5 5 5 1 1 1 2 2 2 2 2 2 2 2 1 1 1 2 2 2 2 1 5 5 1 6 5 5 5 1 0 0 0 4 4 0 4 0 0 0 6 0 0 0 
6 1 5 5 5 5 5 5 1 1 1 1 2 2 2 2 2 2 2 2 1 5 5 2 2 2 2 1 5 5 6 7 6 6 5 5 6 0 0 6 6 0 0 0 0 0 0 0 0 6 
0 0 5 5 5 5 1 1 1 2 2 2 2 2 2 2 2 2 2 2 1 1 1 2 1 2 2 1 5 5 5 6 7 7 6 0 0 0 4 6 6 0 0 0 0 0 6 6 0 6 
0 0 0 1 1 1 1 2 1 1 1 2 2 2 2 2 2 2 2 2 1 2 2 2 2 2 2 1 1 1 1 5 6 6 0 0 0 6 0 0 1 0 0 6 6 0 6 7 6 6 
0 0 3 5 5 5 1 2 2 2 2 2 2 2 2 2 2 2 2 2 1 2 2 2 2 2 2 1 1 2 1 5 5 5 5 5 6 1 1 0 0 4 0 5 6 4 4 6 7 6 
6 0 0 5 5 5 1 2 2 2 2 2 2 2 2 2 2 2 2 2 2 2 2 2 2 2 2 2 2 2 1 5 5 5 6 6 7 6 5 0 0 0 0 5 6 0 6 7 7 7 
7 6 5 5 5 5 1 2 2 2 1 2 1 2 2 2 2 2 1 1 2 2 2 1 1 1 2 2 2 1 1 3 5 5 0 0 6 7 6 0 5 5 0 5 0 0 5 6 7 6 
7 7 6 5 5 5 1 2 1 1 1 2 2 2 2 2 2 1 5 1 1 1 1 6 5 5 1 1 1 3 1 5 6 5 5 1 5 6 0 0 0 6 0 6 6 4 6 7 7 7 
7 7 7 6 5 5 3 1 1 1 1 2 2 2 2 2 2 1 1 1 5 5 5 5 5 3 6 6 1 3 6 6 7 6 5 5 5 6 0 0 6 7 6 6 7 6 4 6 7 7 
6 7 7 7 6 6 6 6 3 5 5 1 1 2 2 2 2 1 1 1 5 5 1 5 5 0 0 0 0 6 7 7 7 7 6 5 1 6 6 4 6 7 7 7 7 6 6 0 6 6 
7 7 6 7 7 6 7 7 6 1 5 1 1 2 2 2 1 5 5 1 5 5 5 1 1 6 0 6 6 7 7 6 7 7 7 6 1 6 7 6 7 7 6 7 7 7 7 6 5 6 
7 6 5 6 6 6 7 6 5 1 5 1 2 2 2 2 1 5 5 5 1 5 0 1 1 5 0 0 0 6 6 7 6 6 6 7 6 7 7 7 6 7 7 7 7 6 6 7 6 7 
6 4 6 7 7 6 7 6 5 1 1 1 2 2 2 2 1 5 5 1 5 5 1 1 1 5 5 0 0 0 5 6 7 7 7 7 7 7 7 7 7 7 6 7 6 6 0 6 7 7 
6 6 7 7 6 7 6 0 5 1 1 1 2 2 2 2 1 5 1 1 5 5 1 5 5 5 6 4 0 0 6 7 6 6 6 6 6 7 7 7 7 7 6 7 6 3 3 5 6 6 
7 7 7 6 7 6 5 5 5 5 5 1 2 2 2 2 1 5 1 0 6 5 1 5 1 1 5 0 0 6 7 6 5 5 6 0 6 7 7 6 7 7 7 6 3 0 0 6 7 7 
7 7 6 4 6 0 0 5 5 3 3 1 2 2 2 2 1 1 6 1 0 6 1 5 6 5 5 0 0 6 6 1 1 0 0 0 6 7 7 6 6 6 6 0 0 0 0 6 6 6 
7 6 0 0 0 0 5 5 3 3 3 1 2 2 2 2 2 2 1 2 1 1 6 5 5 5 5 0 0 0 0 1 1 6 0 0 0 6 7 7 6 7 6 0 0 6 0 0 6 0 
6 5 6 0 3 6 1 5 5 5 1 1 2 2 2 2 2 2 2 2 1 1 5 1 5 5 5 5 0 6 0 1 5 6 3 3 6 7 7 7 7 6 0 0 0 0 0 6 7 6 
7 6 7 6 3 5 5 5 5 5 1 1 2 2 1 1 2 2 2 2 1 1 5 5 5 0 0 3 0 5 0 6 6 4 6 6 7 7 6 7 6 5 0 0 0 6 6 7 7 7 
6 7 6 0 0 5 5 3 5 5 0 6 5 1 0 1 1 1 2 2 2 2 2 1 1 1 1 3 0 1 6 6 6 0 0 3 6 7 6 6 5 5 0 0 6 7 7 7 7 6 
6 6 5 5 5 5 0 6 1 5 0 6 5 5 0 0 1 1 1 1 2 2 2 1 5 5 5 5 0 6 0 0 0 0 0 0 6 6 0 0 5 6 0 0 6 6 7 7 6 0 
0 5 5 5 5 0 0 5 5 5 0 6 0 5 1 6 0 1 5 5 2 2 2 1 1 1 5 1 6 0 0 0 0 0 0 0 6 0 0 0 5 5 6 6 7 7 7 6 1 0 
6 3 3 0 0 0 6 1 0 0 0 3 5 5 5 0 0 3 3 0 1 1 1 5 0 3 6 5 5 0 0 0 0 0 0 0 6 0 0 1 5 5 5 5 6 7 7 7 6 6 