0 0 0 0 0 0 0 0 0 0 0 0 0 0 20 0 0 0 0 20 0 0 8 0 0 
26 0 0 0 0 0 0 0 0 0 0 0 0 0 0 0 0 0 22 15 1 0 0 29 0 
0 0 0 0 0 0 0 0 0 0 0 0 0 0 0 0 30 0 0 3 0 0 0 0 0 
0 0 0 0 0 0 0 0 0 0 0 0 0 0 0 0 0 0 0 0 0 0 0 0 0 
0 0 0 0 0 0 0 0 0 0 0 0 0 0 0 24 5 0 0 0 0 0 20 0 0 
0 0 0 0 0 0 0 0 0 0 0 0 0 0 0 0 0 6 0 0 0 0 0 0 0 
0 0 0 0 0 0 0 0 0 0 0 0 0 0 0 0 0 20 0 0 0 0 2 10 0 
0 0 0 0 0 0 0 0 0 0 0 0 0 0 0 0 0 5 4 6 19 22 26 0 6 
0 0 0 0 0 0 9 0 0 0 0 0 0 21 0 0 0 0 0 2 3 0 0 0 0 
0 0 0 0 0 0 0 0 0 0 0 0 0 0 0 0 0 0 2 6 0 0 0 0 0 
0 0 0 0 0 0 0 0 0 0 0 0 0 0 0 0 4 10 19 0 0 0 0 0 0 
0 0 0 0 29 0 0 0 10 0 0 0 0 0 0 0 0 0 0 0 0 0 0 0 16 
0 0 0 0 0 0 0 0 0 0 0 0 0 0 0 0 0 0 0 0 0 4 0 0 0 
0 0 0 0 0 17 0 0 0 19 0 0 0 0 0 0 0 0 0 0 0 0 0 0 24 
0 0 0 1 0 3 0 0 0 0 0 0 0 0 0 0 0 0 0 0 0 0 0 0 4 
0 0 0 0 0 0 0 0 29 0 0 0 0 0 0 0 0 0 0 0 0 0 0 0 0 
8 0 0 0 0 0 0 0 0 0 0 0 0 0 9 17 19 0 0 0 0 0 0 0 29 
0 0 0 0 0 0 0 0 0 0 0 0 0 0 0 0 0 0 0 0 0 0 0 0 0 
0 0 0 0 0 0 0 0 0 0 0 0 5 5 0 4 0 23 0 4 0 0 0 0 0 
0 0 0 0 0 0 0 0 0 0 0 0 0 0 0 0 0 0 0 4 0 0 0 0 0 
0 0 0 0 0 0 0 0 0 0 0 0 0 26 26 0 0 0 0 0 0 0 0 0 0 
0 0 0 0 0 0 0 0 0 0 0 0 0 0 0 0 0 0 30 0 0 29 0 0 0 
0 0 0 0 12 0 0 7 0 0 0 2 0 0 0 15 0 0 0 0 0 0 0 0 0 
0 0 0 0 0 16 26 0 0 0 22 0 0 0 0 0 0 0 0 0 18 0 0 0 0 
0 0 0 0 0 0 0 0 0 0 0 0 0 0 0 0 0 0 11 0 0 0 0 0 0 