0 0 0 0 41 27 0 38 0 1 0 39 0 0 20 0 0 33 0 0 
0 0 0 0 1 4 0 1 0 50 0 0 0 3 0 0 11 57 0 0 
0 0 0 0 39 37 0 0 0 0 39 37 2 0 0 28 0 40 0 0 
0 0 0 0 0 0 0 0 38 16 0 20 5 0 0 42 0 0 0 0 
0 0 0 0 46 20 32 0 30 0 0 51 0 30 6 0 31 0 0 0 
0 0 33 0 0 50 7 0 0 2 5 0 41 0 41 0 0 35 0 0 
0 0 4 0 6 0 7 0 0 0 0 0 9 0 0 0 6 0 0 0 
0 0 1 0 0 38 0 0 0 0 37 0 0 1 0 0 38 34 0 0 
0 0 8 12 0 0 41 0 0 0 3 0 0 0 17 44 35 36 30 0 
0 0 0 0 42 0 0 0 0 0 0 0 0 0 0 0 0 0 0 0 
0 0 47 46 0 0 55 2 0 0 0 37 21 5 0 0 55 0 0 0 
0 0 0 0 0 0 0 46 0 0 0 0 21 0 0 0 42 0 0 0 
0 37 0 0 0 0 0 0 0 0 0 4 11 44 55 0 0 29 0 0 
0 0 33 0 0 0 0 0 0 0 0 0 0 0 34 31 34 0 0 0 
0 0 0 0 0 0 0 0 0 0 0 0 3 0 32 0 0 0 0 0 
0 0 0 0 0 27 0 0 0 0 0 42 0 46 0 0 0 0 0 0 
0 0 0 0 0 0 0 0 40 0 0 6 0 4 0 0 0 0 0 0 
0 0 0 0 0 0 2 41 0 0 0 37 26 0 0 0 0 0 0 0 
0 0 0 0 0 0 0 0 0 0 0 0 2 45 0 0 0 0 5 0 
0 0 0 0 0 0 0 0 0 0 0 0 2 0 0 0 0 9 0 0 