0 15 0 0 0 0 0 0 0 0 0 0 0 0 0 0 0 0 0 0 0 0 0 0 0 0 0 0 0 0 0 0 0 0 0 0 0 0 0 32 
0 0 0 44 0 22 0 0 0 0 0 0 0 0 0 0 0 0 0 0 0 0 0 0 0 0 0 0 0 0 0 0 0 0 0 0 0 0 0 4 
0 0 36 5 6 33 0 0 0 0 0 0 0 1 0 0 35 0 1 0 0 0 0 0 0 0 0 0 0 0 0 0 0 0 0 0 0 0 0 6 
0 0 0 0 0 0 0 0 0 0 0 0 0 9 0 0 0 42 0 0 0 0 0 0 0 42 6 56 0 44 0 0 0 0 0 0 0 0 0 0 
0 0 0 0 0 0 0 0 0 0 0 0 0 19 41 0 0 0 32 0 0 6 0 0 0 36 6 0 0 0 0 0 0 0 0 0 0 0 0 0 
0 0 0 0 0 0 0 0 0 0 0 0 0 0 0 15 34 35 0 0 0 0 0 30 38 0 0 0 55 0 0 0 0 0 0 0 0 0 0 0 
0 0 0 0 0 0 0 0 0 0 0 0 0 0 0 0 0 0 0 0 0 41 5 0 0 6 0 0 47 0 0 0 0 0 0 0 0 0 0 0 
0 0 0 0 0 0 0 0 0 0 0 0 3 0 42 0 0 0 0 27 50 33 0 38 0 0 0 0 0 0 0 0 0 0 0 0 0 0 45 47 
0 0 0 0 0 0 0 0 0 0 0 0 0 0 0 0 0 0 0 0 0 0 0 0 0 0 0 0 0 0 0 0 0 0 0 0 0 0 39 0 
0 0 0 0 0 0 0 0 0 0 0 0 36 0 3 0 0 0 0 0 0 0 38 0 0 0 0 0 0 0 0 0 0 0 0 0 0 0 0 44 
0 0 0 0 0 0 0 0 0 0 0 0 0 2 0 0 0 0 0 0 0 0 8 0 0 0 0 0 0 3 25 11 42 15 0 0 0 0 0 0 
0 0 0 0 0 0 0 0 0 0 0 0 0 0 0 0 0 0 0 0 0 0 0 0 11 0 0 0 52 6 0 0 34 0 0 0 0 0 0 0 
0 0 0 0 0 0 0 0 0 0 0 6 39 19 0 0 34 36 0 12 0 0 0 0 0 0 0 0 5 0 0 0 0 2 0 0 0 0 0 0 
0 0 0 0 0 0 0 0 0 0 0 0 0 0 0 0 0 0 8 9 0 0 0 0 0 0 0 0 0 2 0 0 0 19 0 0 0 0 0 0 
0 0 0 0 0 0 0 0 0 54 42 10 4 0 38 0 0 0 38 0 0 0 0 0 0 0 0 0 0 4 0 0 36 7 0 0 0 0 22 0 
0 54 0 0 0 0 0 0 0 0 37 0 0 0 0 0 0 47 40 0 0 0 0 0 0 0 0 0 0 0 0 0 29 0 0 0 0 0 0 0 
0 6 32 0 0 0 0 0 0 0 0 3 17 0 46 0 39 54 34 0 0 0 0 0 0 0 0 0 0 0 0 0 25 0 0 0 0 0 0 0 
0 0 0 0 0 0 0 0 0 40 6 32 0 0 33 25 38 0 0 0 0 0 0 0 0 0 36 39 0 0 0 0 0 0 0 0 0 0 0 40 
0 0 0 0 32 0 0 0 0 0 5 0 47 35 4 7 0 0 0 0 0 0 0 1 35 0 0 55 0 0 0 0 0 38 0 0 0 0 0 7 
0 0 0 0 0 39 0 0 7 6 0 0 0 0 0 26 32 0 0 0 0 0 0 5 0 52 0 0 0 1 6 0 35 0 0 0 0 0 0 7 
0 0 0 0 0 7 0 0 42 36 1 0 0 0 0 0 0 0 0 0 0 2 35 0 45 31 26 2 0 0 29 55 0 28 0 0 0 0 0 0 
0 0 0 0 0 0 0 0 0 0 32 0 0 0 0 0 1 0 0 37 0 33 0 46 0 0 0 0 0 0 0 0 41 0 0 0 0 0 0 0 
0 0 0 42 2 0 30 0 35 0 0 0 0 0 0 0 4 0 37 0 0 0 0 0 29 54 0 55 0 0 0 0 11 0 0 0 0 0 0 0 
0 0 54 0 0 0 45 42 40 0 0 0 0 0 0 0 0 0 0 8 0 0 0 0 18 0 35 0 0 0 0 0 0 0 0 0 0 0 0 0 
0 4 15 0 0 0 0 0 0 0 0 0 0 0 0 0 0 0 41 0 0 0 0 0 0 0 54 0 0 0 0 0 0 0 0 0 0 0 0 0 
0 0 0 0 0 0 0 0 0 0 0 0 0 0 0 0 0 0 0 0 0 0 0 0 0 0 0 0 0 0 0 0 0 0 0 0 0 0 0 0 
0 4 0 38 0 0 0 0 0 3 0 0 5 0 0 0 0 0 0 0 0 0 0 0 0 0 0 0 0 0 0 0 0 0 0 0 0 0 0 0 
0 50 12 17 0 0 0 0 0 54 0 42 0 0 0 0 0 0 0 0 0 0 0 0 0 0 0 0 0 0 0 0 2 4 0 0 7 37 0 1 
0 0 0 0 0 0 0 0 0 0 0 4 0 0 0 0 0 0 0 0 0 0 0 0 0 6 6 0 0 0 0 0 24 0 0 0 0 0 35 0 
0 0 0 0 0 0 0 0 0 22 0 0 0 0 0 31 0 4 3 0 0 0 0 0 0 0 3 0 0 0 0 36 0 0 34 6 0 40 0 4 
0 0 0 0 0 46 0 0 0 0 0 0 26 0 0 0 0 5 0 0 0 0 0 0 0 0 0 0 0 0 0 27 0 0 0 0 0 0 0 0 
0 0 0 4 0 4 0 0 0 0 0 0 0 0 0 0 0 3 0 0 0 0 0 0 0 0 0 0 0 0 0 35 0 0 0 0 26 0 5 0 
0 0 0 0 0 0 0 0 0 0 0 0 41 32 0 41 0 0 0 0 0 0 31 0 0 0 0 7 0 45 0 0 0 0 0 0 0 4 51 45 
0 0 0 0 35 0 0 0 0 0 0 0 0 0 7 0 0 0 0 0 0 0 0 0 0 0 0 41 0 0 0 31 0 0 0 0 0 50 0 0 
0 0 0 0 31 5 0 0 0 0 0 0 0 0 0 0 0 36 6 19 0 0 0 0 0 0 0 34 0 0 0 0 0 0 0 21 1 0 0 0 
0 0 0 0 0 0 0 0 0 0 0 0 5 34 31 0 0 37 0 40 27 0 0 0 0 0 0 4 0 55 0 0 0 0 0 0 10 0 0 0 
0 0 0 0 0 0 0 0 0 0 12 0 0 0 4 0 0 0 0 41 17 0 0 0 0 0 0 40 0 0 1 31 0 0 0 0 0 0 0 0 
0 0 0 0 0 0 0 0 42 0 0 0 0 0 0 0 0 0 0 0 0 0 0 0 0 0 0 0 0 0 1 0 0 0 0 0 0 0 0 0 
0 0 0 0 0 0 0 0 0 0 0 0 0 0 0 0 0 0 0 0 0 0 0 0 0 0 0 42 4 0 0 0 0 0 0 0 0 0 0 0 
0 0 0 0 0 0 0 0 0 0 3 0 0 0 0 0 0 0 0 0 0 0 0 0 0 0 0 0 52 0 0 0 0 0 0 0 0 0 0 0 