41 0 54 0 7 35 22 11 14 46 36 11 5 31 33 5 56 43 12 0 46 32 6 10 41 27 27 52 37 26 12 15 22 42 5 11 4 39 17 12 
52 40 37 19 39 31 4 15 10 32 24 15 44 6 18 57 9 45 45 21 32 46 42 14 14 13 12 43 53 48 27 49 13 12 12 22 39 47 47 54 
17 38 44 29 25 20 36 24 48 7 1 48 0 17 41 20 54 13 55 35 7 22 38 54 4 8 7 31 39 23 5 2 52 31 7 33 3 38 44 55 
26 6 18 45 48 45 49 38 18 25 33 9 50 31 48 10 26 55 10 51 17 9 18 34 39 21 26 7 45 47 43 20 36 49 0 25 18 52 49 25 
37 27 4 49 11 14 13 2 47 11 32 51 10 8 54 0 1 27 14 46 5 27 0 39 29 8 38 53 38 41 8 10 19 14 49 32 47 12 42 55 
1 53 9 43 6 3 3 6 41 17 6 0 33 55 51 6 14 41 23 49 25 5 6 0 52 26 51 33 27 0 39 18 28 27 35 6 13 15 0 0 
29 12 27 38 42 55 33 48 27 21 52 24 25 15 40 22 32 5 15 7 20 52 24 50 3 45 31 4 0 54 15 48 23 17 3 9 0 38 0 20 
26 28 23 29 6 5 3 31 29 53 42 27 50 41 41 24 51 22 26 21 45 48 54 44 2 34 33 20 15 5 16 17 26 26 47 35 52 29 0 0 
4 25 22 22 29 28 0 53 5 0 6 49 0 28 31 39 29 42 40 0 25 35 36 33 31 49 4 51 30 20 57 49 17 13 5 54 29 19 0 0 
19 42 24 0 27 17 0 8 51 19 32 46 1 45 41 0 32 29 39 14 3 41 43 32 12 29 48 41 54 29 14 21 38 50 50 8 29 45 0 0 
52 0 25 53 47 43 10 24 47 5 42 40 34 12 42 25 29 39 10 0 15 33 27 9 32 40 0 33 45 25 31 54 15 8 5 50 2 47 0 0 
6 28 11 6 39 50 29 55 45 48 14 16 6 22 25 38 30 47 15 2 47 47 34 18 26 29 54 0 41 44 35 47 32 0 0 1 19 41 0 0 
4 49 4 8 40 51 33 38 36 8 49 15 3 34 23 0 7 11 35 31 0 52 11 27 44 23 13 50 44 0 0 41 43 38 32 57 0 0 0 0 
41 52 0 27 35 0 44 7 2 12 11 4 24 7 23 10 2 50 44 8 30 4 6 40 3 40 35 38 40 31 9 38 55 17 16 28 42 0 0 0 
11 12 27 42 0 28 17 51 6 34 27 16 8 4 6 0 29 14 0 16 0 29 0 40 56 35 53 29 14 21 4 12 28 50 49 41 13 41 38 0 
45 21 19 26 28 54 23 0 38 43 27 40 27 0 23 50 12 2 48 38 23 28 37 10 13 13 56 47 0 0 13 1 38 30 52 0 4 46 28 0 
52 40 28 38 23 20 24 55 38 0 32 17 44 10 5 54 36 17 11 3 34 26 39 28 36 2 25 24 44 0 42 33 24 13 0 41 35 0 0 0 
0 18 9 0 17 0 8 17 14 25 13 1 38 55 16 36 23 43 7 20 3 8 34 10 4 3 41 27 1 50 46 8 48 51 3 21 20 19 0 0 
0 0 38 12 11 2 30 1 21 54 8 39 42 55 44 41 47 26 0 2 41 9 55 31 45 18 48 53 56 43 49 23 29 19 12 52 30 37 0 0 
0 0 32 32 26 16 34 43 0 22 26 0 0 49 56 16 6 57 27 0 14 3 54 40 5 46 23 33 4 49 39 41 29 17 45 38 12 8 0 0 
0 0 0 0 0 0 0 0 0 0 0 0 0 0 0 0 29 4 21 11 0 23 0 53 30 51 40 49 36 38 3 52 7 55 52 6 28 46 0 0 
0 0 0 0 0 0 0 52 0 0 0 0 0 0 0 0 41 45 12 52 15 8 31 44 26 25 23 47 16 18 10 2 54 46 46 49 10 53 0 0 
0 0 0 0 0 0 42 2 0 0 0 0 0 0 0 0 0 27 30 30 57 52 54 11 41 10 0 3 30 48 46 36 29 34 14 38 27 49 0 0 
0 0 0 0 0 0 0 0 0 0 0 0 0 0 0 0 0 8 30 14 15 10 0 0 50 40 0 41 37 45 5 29 54 32 33 53 56 45 0 0 
0 0 0 0 0 0 0 0 0 0 0 0 0 0 0 0 37 40 50 7 15 8 28 51 38 51 36 36 57 29 8 0 7 30 22 25 44 40 0 0 
0 0 27 0 0 0 0 0 0 0 0 0 0 0 0 0 30 44 20 36 47 44 8 29 26 0 18 21 57 26 41 42 46 37 53 54 0 56 0 0 
0 0 0 0 0 0 0 0 0 0 0 0 0 0 0 0 26 14 44 38 51 49 39 32 21 52 6 36 25 51 52 26 55 38 39 27 27 42 0 0 
0 0 0 0 0 0 0 0 0 0 0 0 0 0 0 0 0 33 25 57 29 56 10 56 14 19 33 32 50 57 25 11 30 21 34 47 25 3 0 0 
0 0 0 0 0 0 0 0 0 0 0 0 0 0 0 0 36 28 47 51 44 26 34 4 25 5 49 20 30 39 11 0 0 36 57 3 45 41 0 0 
0 0 0 0 0 0 0 0 0 0 0 0 0 0 0 0 0 13 23 48 19 45 42 46 42 0 57 1 35 25 7 36 45 34 49 54 0 33 0 0 
0 0 0 0 0 0 0 20 35 0 0 0 0 0 0 0 34 53 18 49 12 44 6 48 49 35 42 52 40 38 32 0 35 5 18 9 43 0 0 0 
0 0 0 0 0 0 0 22 55 0 0 0 0 0 0 0 39 16 17 35 47 22 41 47 25 41 16 29 42 24 51 51 31 23 49 29 15 7 0 0 
0 0 0 0 0 0 0 0 0 0 0 35 0 0 0 0 40 3 5 15 36 47 12 7 26 34 28 33 5 44 33 52 18 36 18 47 21 38 3 0 
0 0 0 0 55 15 0 0 0 0 0 10 40 0 0 0 8 25 6 42 4 18 17 13 36 17 46 19 4 39 0 42 0 48 12 24 40 27 48 0 
55 13 0 0 35 11 0 0 0 0 0 0 48 0 0 0 45 46 11 16 28 0 40 48 35 39 3 33 38 24 44 44 39 38 7 33 52 16 39 0 
37 40 0 0 0 53 41 0 0 0 0 9 2 0 0 0 0 0 0 33 14 2 33 28 44 0 11 36 24 55 55 50 57 54 2 33 50 3 7 0 
0 0 0 0 0 53 7 0 0 0 0 26 12 0 0 0 51 34 3 40 20 9 18 42 29 38 22 16 38 3 8 45 3 44 26 5 25 35 0 0 
0 0 0 0 0 16 0 0 0 0 0 26 0 0 0 0 21 19 8 52 36 3 44 45 0 42 17 38 22 5 38 6 0 0 17 0 22 3 0 0 
0 0 0 0 0 44 25 0 0 0 0 36 37 0 0 0 0 41 54 16 40 46 7 4 22 53 31 0 41 9 50 49 46 18 21 12 18 14 0 0 
0 0 0 0 0 0 0 0 0 0 0 34 24 0 0 0 0 41 43 45 35 21 17 1 34 22 7 24 56 52 42 51 42 56 3 24 12 18 0 0 