0 0 0 0 0 0 0 0 0 0 0 0 0 39 1 0 22 0 0 0 0 0 0 0 0 0 0 0 0 0 0 0 0 52 0 0 0 0 0 0 
0 0 0 0 0 0 0 0 0 0 0 0 0 35 2 0 0 0 0 0 0 0 0 0 0 0 0 0 0 0 0 0 36 54 0 0 0 0 0 0 
0 0 0 0 0 0 54 0 0 0 0 0 0 38 0 6 42 0 0 0 0 0 0 0 0 0 0 0 0 0 0 0 5 0 0 0 0 0 0 0 
0 0 0 0 12 0 0 0 0 0 0 0 0 0 42 41 33 0 0 0 0 0 0 0 0 0 0 0 0 0 0 0 0 0 0 0 0 0 0 0 
0 0 0 0 0 0 0 0 0 0 0 0 0 0 0 0 5 0 0 0 23 0 0 0 0 0 0 0 0 0 0 0 0 0 0 0 0 0 0 0 
0 0 0 0 0 0 0 0 0 0 0 0 0 0 2 1 0 0 0 1 33 0 38 0 32 41 0 0 0 0 44 0 0 0 0 0 0 0 0 0 
0 0 0 42 0 0 0 0 0 0 0 0 17 0 45 32 15 0 0 27 35 34 0 7 0 33 0 0 0 35 0 0 54 0 0 0 0 0 0 0 
0 0 0 0 22 0 0 0 0 0 0 0 0 0 0 0 0 0 0 0 0 0 0 35 36 0 0 0 0 0 0 38 0 0 0 0 0 0 0 0 
0 0 0 0 42 0 0 0 0 0 2 0 0 18 0 33 0 0 0 0 0 3 0 5 45 33 0 0 0 0 0 0 0 0 0 0 0 0 43 37 
0 0 0 0 0 0 0 0 0 0 0 38 36 0 0 0 0 0 0 0 0 0 0 0 5 31 0 0 0 0 0 0 0 0 0 0 0 0 0 0 
0 0 0 0 0 0 0 0 0 0 16 19 0 0 0 0 41 0 0 0 0 0 0 0 34 0 0 0 0 0 0 0 0 0 0 26 0 0 0 0 
0 0 34 0 6 0 0 0 0 0 38 0 0 46 4 42 44 0 0 0 0 0 0 0 0 35 0 0 0 0 0 0 0 0 2 19 0 0 0 42 
0 0 0 0 0 0 10 0 0 0 0 0 0 49 0 37 0 0 0 0 0 0 0 0 10 40 0 0 0 0 0 0 0 0 0 0 0 0 26 0 
0 0 0 0 0 11 34 0 0 0 55 0 0 11 42 0 0 0 0 0 0 0 0 0 0 0 0 0 0 0 0 0 0 0 0 0 0 0 45 0 
33 29 5 0 38 34 0 0 0 23 0 0 0 0 4 0 0 0 0 0 0 0 0 0 0 55 0 0 6 0 0 0 0 0 36 0 0 0 0 0 
0 12 15 25 6 32 24 0 0 0 32 0 0 17 0 0 0 0 0 0 0 0 0 0 54 9 0 54 0 0 0 0 0 55 0 0 0 0 0 0 
0 0 0 41 0 0 0 0 0 0 35 0 19 0 0 0 0 0 0 0 0 0 0 0 0 7 0 40 34 0 0 0 0 0 0 0 0 0 0 0 
0 21 3 0 0 0 36 23 0 0 0 3 0 0 0 0 0 0 0 5 27 33 0 0 0 0 0 0 0 0 0 0 0 0 0 0 0 0 0 0 
0 0 57 0 36 0 0 39 0 0 0 0 45 0 0 0 0 0 0 7 0 0 0 0 24 4 4 41 0 0 0 0 0 0 0 0 0 0 0 0 
0 3 0 0 0 0 8 0 0 0 0 6 42 0 0 0 0 0 0 31 2 0 0 0 0 0 40 24 11 6 33 1 22 32 0 0 0 0 0 0 
0 0 0 39 40 0 0 0 0 0 0 0 0 0 0 0 0 0 0 0 0 0 0 0 0 6 19 0 0 0 0 0 35 0 0 0 0 0 0 0 
0 0 0 0 0 0 0 0 0 0 4 0 0 0 0 0 0 0 0 0 0 0 0 0 2 0 0 0 0 33 7 6 17 41 0 0 0 0 0 0 
2 0 0 0 0 0 0 0 0 39 0 38 0 0 0 0 0 0 0 0 0 0 0 0 0 0 0 4 39 0 0 0 0 0 0 0 0 0 0 0 
0 0 0 0 0 0 0 0 0 0 0 0 0 0 0 0 0 0 0 0 1 0 0 0 0 0 5 0 1 0 0 0 0 0 0 32 38 0 0 0 
0 0 40 0 0 0 0 0 0 0 0 0 0 0 0 54 33 0 0 0 4 0 33 0 0 0 0 42 0 0 0 0 0 0 0 0 0 0 0 0 
0 0 8 32 0 0 0 0 0 0 4 4 0 0 0 0 0 0 0 33 31 0 3 42 0 0 0 0 0 0 0 0 0 0 0 40 45 9 0 0 
0 0 0 0 0 0 0 0 0 0 0 0 47 0 0 0 48 4 0 0 40 0 49 0 32 0 0 0 0 0 0 0 0 0 0 0 0 0 0 0 
0 0 0 0 0 0 0 0 0 0 0 0 42 32 0 0 0 0 0 0 0 0 0 0 37 0 0 0 0 0 0 0 0 0 0 0 0 0 0 0 
0 0 0 0 0 0 0 0 0 0 0 0 0 0 0 0 0 0 0 0 0 0 0 0 0 0 0 0 0 0 0 0 0 0 0 0 0 0 0 0 
0 0 0 0 0 0 0 0 0 0 0 0 0 0 0 0 0 0 0 0 0 0 0 0 0 0 0 0 0 0 0 0 0 0 0 0 0 40 0 0 
0 0 0 0 0 0 0 0 0 0 0 4 3 0 33 31 0 0 0 0 0 0 0 0 0 0 0 0 37 31 0 0 0 0 0 0 0 53 0 0 
0 0 0 0 0 0 0 0 0 0 0 0 0 0 41 0 35 0 0 0 0 0 0 0 0 0 0 0 1 39 0 0 0 0 0 0 0 0 0 0 
0 0 0 0 11 0 0 0 0 0 0 0 0 0 0 0 0 0 0 0 0 0 0 0 0 0 0 0 0 0 0 0 0 0 0 0 0 0 0 9 
0 0 0 41 0 0 0 0 0 0 0 0 0 0 0 0 0 0 0 19 0 0 37 0 1 4 33 0 0 0 0 0 0 0 0 0 35 26 0 43 
0 0 0 9 4 0 0 0 0 0 0 0 0 0 0 0 0 0 0 0 41 21 0 0 52 0 26 0 34 5 0 0 0 55 0 42 2 19 0 40 
0 21 0 0 0 0 0 41 0 0 0 0 0 0 0 0 0 0 0 0 0 0 55 0 42 0 0 0 0 0 0 0 5 53 0 0 42 39 0 0 
0 40 0 0 0 0 0 0 0 0 1 0 40 0 3 0 0 0 0 0 0 0 15 0 32 0 4 0 0 0 0 0 0 0 0 0 0 0 0 0 
0 0 0 0 0 0 0 29 0 0 0 29 0 9 7 34 0 0 0 2 0 0 0 0 28 0 32 0 0 0 0 0 0 6 4 0 0 0 0 0 
0 0 0 0 0 0 4 7 0 0 0 0 0 0 0 0 0 0 0 0 36 0 0 55 0 0 15 0 0 0 0 0 0 0 0 0 0 0 0 0 
0 0 0 0 0 0 22 38 0 0 0 0 0 34 3 0 0 0 0 0 0 0 0 0 0 0 0 0 0 0 0 0 0 0 0 0 0 0 0 0 