31 34 0 0 0 0 0 0 0 0 0 0 0 0 0 0 0 0 0 0 0 0 0 0 0 0 0 0 0 0 0 0 0 0 0 0 0 0 0 0 
31 54 0 0 0 0 0 0 0 0 0 0 0 0 0 0 0 0 0 0 0 0 0 0 0 0 0 0 0 0 0 0 0 0 0 0 0 0 0 0 
0 0 0 0 0 0 0 0 0 0 0 0 0 39 40 0 0 0 0 0 0 0 0 0 0 0 0 2 0 0 0 0 0 0 0 0 0 0 0 0 
0 0 0 0 0 0 0 0 38 0 0 0 0 27 43 0 0 0 0 0 0 0 0 0 0 0 0 0 0 28 0 0 0 0 0 0 0 0 0 0 
0 0 0 0 0 0 0 23 0 0 0 0 0 42 40 0 0 0 0 35 0 0 0 0 0 0 0 0 0 0 0 0 0 0 0 43 4 0 0 0 
0 0 0 0 0 0 0 0 0 0 0 0 0 0 0 43 33 5 0 0 0 0 0 0 0 0 0 0 0 0 0 0 0 0 0 41 0 0 0 0 
0 0 0 0 0 2 0 0 0 0 0 0 0 0 0 0 0 0 0 0 0 0 0 34 0 0 0 0 0 0 9 0 0 0 0 0 0 0 0 0 
0 0 0 24 0 41 0 0 0 0 0 0 0 0 0 0 0 0 0 0 34 20 31 10 2 0 8 0 37 0 39 0 0 0 0 0 0 0 0 0 
0 0 0 40 0 0 0 0 0 0 0 0 0 0 0 0 0 0 0 1 19 0 0 0 0 0 31 0 0 42 54 0 0 0 0 0 0 0 0 0 
0 0 0 0 0 0 0 0 0 0 1 41 0 44 34 0 0 0 0 0 0 0 0 0 0 0 0 5 0 0 0 0 0 0 0 0 0 0 0 0 
0 0 0 0 0 0 0 0 0 0 6 0 0 39 0 0 0 0 0 0 0 0 0 0 0 0 0 0 0 0 0 0 0 0 0 0 0 0 0 0 
0 0 0 0 0 0 0 0 0 0 0 0 0 0 0 0 0 0 0 0 0 0 0 0 0 0 0 0 0 39 0 49 0 0 0 0 6 0 0 0 
55 0 0 0 0 0 0 0 0 0 0 0 0 0 0 0 42 0 0 0 0 0 0 0 0 0 41 0 0 0 0 0 0 0 18 39 0 0 33 0 
0 44 0 0 0 0 0 0 0 0 53 2 24 0 0 0 33 1 0 0 0 0 0 0 0 0 0 0 0 0 0 37 0 0 42 0 38 0 1 0 
0 0 0 0 0 0 0 0 0 0 3 39 0 0 0 0 0 0 16 0 0 0 3 0 0 0 0 0 0 0 5 40 0 0 0 0 20 0 4 0 
0 0 0 0 0 0 0 0 0 0 0 0 0 0 0 0 0 46 41 21 0 30 54 0 0 0 0 0 0 0 0 0 0 0 0 0 0 0 33 0 
49 0 0 0 0 0 0 34 36 0 33 0 0 0 0 0 32 0 0 56 25 0 0 0 0 0 0 40 0 0 0 0 0 0 0 0 0 0 0 0 
0 0 0 0 0 0 0 0 0 0 0 0 0 0 0 0 0 0 0 0 0 0 0 0 0 0 0 0 0 26 0 0 0 0 0 0 0 1 0 0 
54 0 0 0 0 0 0 40 5 0 0 20 0 17 42 37 0 0 0 0 41 1 0 0 0 0 0 1 0 0 6 23 0 12 0 0 41 36 46 0 
0 0 0 0 0 0 0 0 0 0 0 41 39 0 41 34 0 0 0 0 0 0 7 0 0 0 0 0 0 0 21 40 55 0 0 0 0 6 24 0 
0 0 0 0 0 0 0 17 20 30 0 0 0 0 0 0 0 0 0 0 0 42 0 0 0 0 0 0 0 0 38 0 5 0 0 0 42 0 0 0 
0 0 0 0 0 0 0 0 0 0 0 0 0 0 17 35 0 0 0 0 0 0 0 0 0 0 0 0 0 0 0 0 0 0 0 0 0 0 42 33 
0 0 0 0 0 0 46 40 0 0 0 0 0 0 0 1 0 0 0 0 0 0 0 0 0 0 0 0 0 0 0 0 0 0 0 0 0 0 0 0 
0 0 35 0 0 0 0 39 0 0 0 0 0 0 0 0 0 0 0 0 0 0 0 0 0 0 0 19 0 0 0 0 0 5 0 0 0 0 0 0 
0 0 1 0 0 0 0 0 0 54 0 0 0 0 38 0 0 0 0 0 54 0 0 0 0 33 0 34 0 0 0 0 38 11 0 0 0 0 0 0 
0 0 0 0 0 0 0 0 0 0 0 0 0 0 0 0 0 0 0 0 0 0 0 0 0 0 0 0 0 0 0 0 23 0 0 0 0 0 0 0 
0 0 0 0 0 0 0 0 0 0 0 0 4 3 0 0 0 0 0 0 0 0 0 0 0 0 0 0 0 0 0 0 36 1 36 0 0 0 0 0 
0 0 39 0 0 0 0 0 0 0 0 0 0 0 0 0 0 55 0 0 0 0 0 0 0 0 0 0 36 39 0 0 0 0 0 0 0 0 0 0 
0 0 5 0 0 0 0 0 0 0 0 0 0 0 0 0 0 0 0 0 0 0 0 20 34 38 0 0 43 21 37 28 36 55 0 0 0 0 0 0 
0 0 34 7 12 0 0 0 0 0 0 22 3 7 0 0 0 0 0 0 54 0 0 55 0 0 0 0 53 33 0 0 0 0 0 0 0 0 0 0 
0 0 0 0 0 0 0 0 0 0 0 37 0 0 0 0 0 0 0 39 0 0 0 0 0 0 0 0 53 12 0 0 0 0 0 0 0 0 0 0 
0 0 0 0 0 0 0 0 37 0 0 0 0 0 0 0 0 0 0 0 0 0 0 0 0 0 0 0 0 0 0 0 5 2 31 0 0 0 0 0 
0 0 0 0 0 0 0 41 0 0 0 0 0 0 0 0 0 0 0 0 0 0 0 0 0 0 0 0 39 12 0 0 0 29 0 55 0 0 0 0 
0 0 0 0 0 0 0 0 0 0 0 0 0 0 0 0 0 0 0 0 0 0 0 0 0 0 41 5 57 0 0 0 0 0 0 0 0 0 0 0 
0 0 0 0 0 0 0 0 0 0 0 46 0 0 0 0 0 0 0 0 0 0 0 0 0 0 5 0 22 54 0 0 30 3 39 31 0 0 0 0 
0 0 0 0 0 0 0 0 0 0 0 0 35 39 0 0 0 0 0 0 0 0 0 43 0 0 0 46 0 24 0 0 0 0 0 0 0 0 0 0 
0 0 0 0 0 0 0 4 0 0 0 32 38 17 0 0 0 0 33 0 0 0 43 11 0 0 0 41 0 36 0 0 0 0 0 0 0 0 0 0 
0 0 0 0 21 37 55 10 0 0 0 35 2 0 0 0 0 22 0 0 0 0 0 0 0 0 0 0 0 0 0 0 0 0 0 0 0 0 0 0 
0 0 0 0 0 0 0 0 0 0 0 0 0 0 0 0 0 40 0 6 0 0 0 0 0 0 0 0 0 0 0 0 54 0 40 0 0 0 0 34 
0 0 0 0 0 0 0 0 0 0 0 0 0 0 0 0 0 0 0 0 0 0 0 0 0 0 0 0 0 0 0 0 0 0 4 0 0 0 0 0 