0 0 0 0 0 0 0 0 0 0 0 0 0 0 0 0 0 0 0 0 3 0 46 0 0 0 22 0 0 51 37 32 0 0 42 41 39 0 0 0 
0 0 12 0 0 0 0 0 0 0 0 0 0 0 0 0 0 0 0 0 37 32 0 0 0 0 38 0 0 28 0 1 0 0 0 0 25 0 0 4 
38 0 31 0 0 0 0 0 0 0 0 0 0 0 0 36 40 0 0 42 0 40 32 0 0 0 0 0 49 17 28 31 0 3 36 0 0 0 0 0 
39 0 0 0 6 0 0 0 0 0 0 0 0 0 0 0 0 0 0 4 51 0 0 0 0 0 0 0 0 0 2 32 0 0 0 0 0 0 0 9 
0 48 0 0 31 33 0 0 0 0 0 0 0 38 0 0 0 0 0 32 34 0 0 0 0 0 0 0 0 0 0 0 23 0 0 0 0 0 0 40 
39 20 0 0 0 0 0 0 0 6 16 0 37 0 0 0 0 0 0 0 0 33 0 0 0 0 0 0 0 0 0 0 0 0 0 0 0 0 0 55 
37 34 0 0 17 0 0 0 0 41 50 0 0 0 0 0 0 0 0 0 0 14 17 0 0 0 0 0 0 0 0 0 0 0 0 32 0 3 0 0 
38 1 0 0 28 0 0 0 0 0 0 0 0 0 0 0 0 0 0 0 0 0 0 0 0 0 0 0 0 0 0 0 0 0 0 46 0 0 0 0 
0 0 0 30 0 0 0 0 0 0 27 0 0 0 0 0 0 0 0 0 0 0 0 0 0 0 0 0 0 0 0 0 0 0 0 54 0 35 0 18 
12 0 3 0 2 4 0 0 0 0 0 0 0 0 0 0 0 0 4 0 36 0 0 0 0 0 0 0 0 0 0 0 0 0 0 41 0 0 0 41 
37 0 31 42 0 0 0 0 3 38 0 0 0 0 0 5 36 0 0 0 0 0 0 0 0 0 0 0 0 0 0 0 0 0 39 0 0 0 0 0 
40 0 0 0 28 2 43 0 21 0 0 0 0 0 0 0 0 0 0 0 0 0 5 0 0 0 0 0 0 0 0 0 0 0 0 0 0 0 0 0 
16 0 0 15 0 0 0 0 0 33 0 0 0 0 0 0 0 0 0 0 0 0 0 0 0 0 0 0 0 0 0 0 0 0 0 37 0 0 0 4 
0 0 40 52 4 0 0 0 38 31 0 39 0 0 0 0 0 39 32 0 0 0 0 0 0 0 0 0 0 20 0 0 0 0 0 0 0 0 0 0 
0 0 0 0 0 0 0 0 0 0 3 0 0 0 0 0 0 0 5 0 0 0 0 0 0 0 0 0 34 3 0 0 0 0 0 0 0 0 0 0 
0 0 0 0 0 0 0 0 0 1 0 0 0 0 0 0 0 0 0 0 0 0 0 0 0 0 0 0 0 55 0 0 0 0 0 0 0 0 0 0 
0 38 37 47 0 0 0 0 0 0 0 0 0 0 0 0 0 0 0 0 0 0 0 0 0 0 0 0 0 30 0 0 0 0 0 0 0 0 0 0 
20 34 0 19 0 0 0 0 0 0 0 0 0 0 0 0 0 0 0 0 4 0 0 0 0 0 0 0 0 33 0 0 0 0 0 0 0 0 0 0 
6 39 0 16 36 0 0 0 0 0 0 0 0 0 5 41 0 0 0 0 5 38 24 55 0 0 31 42 12 0 33 30 0 0 0 0 0 0 0 0 
0 0 0 0 16 0 0 0 0 0 0 0 37 0 0 30 14 2 23 0 32 0 0 0 0 0 45 4 0 55 41 0 38 11 0 0 0 0 0 0 
0 0 0 0 0 0 0 0 0 0 0 0 0 0 0 0 0 0 0 0 0 0 0 44 0 0 0 37 4 0 30 0 0 18 0 0 0 17 0 0 
0 0 0 0 0 0 0 0 0 0 0 14 35 0 0 0 0 0 0 0 0 0 0 42 3 39 0 0 0 0 52 0 0 30 0 0 0 0 0 0 
0 0 0 0 0 0 0 0 0 0 0 0 0 0 0 0 0 0 0 0 0 0 0 43 0 0 0 27 38 0 0 0 0 2 0 0 0 0 0 0 
0 0 0 0 0 0 0 0 0 0 0 0 0 0 0 0 0 0 0 0 0 0 0 29 37 33 38 0 0 0 32 0 6 0 0 0 0 0 0 0 
0 0 0 0 0 0 0 0 0 0 0 0 0 0 1 30 0 0 0 0 0 0 0 0 0 46 19 35 0 33 0 25 0 0 0 0 0 0 0 0 
0 0 0 0 0 0 0 0 0 0 7 0 0 0 0 41 0 0 0 0 0 0 0 0 0 0 34 36 34 40 55 53 0 0 0 0 0 0 0 0 
0 0 0 0 0 0 0 0 0 42 0 28 0 0 0 0 0 0 0 0 0 0 0 0 32 0 22 0 0 0 31 0 0 0 0 0 0 0 0 0 
0 0 0 0 0 0 0 0 0 0 0 0 0 0 0 0 0 0 0 0 0 0 0 0 0 0 55 55 0 5 0 33 0 0 0 0 0 0 0 0 
0 0 0 0 0 0 0 0 0 0 44 0 0 0 0 34 0 0 0 0 0 0 0 0 0 15 0 54 0 0 51 0 0 54 0 0 0 0 0 0 
0 0 0 0 0 0 0 0 0 0 36 0 0 0 0 2 0 0 0 0 0 0 0 0 0 0 0 0 0 0 0 0 0 0 0 0 0 0 0 0 
0 0 0 0 0 0 0 0 0 0 0 0 0 0 0 0 0 0 0 42 0 0 0 0 0 0 11 10 54 0 0 2 0 33 0 4 0 0 0 0 
0 0 0 0 0 0 0 0 0 0 0 0 0 0 0 0 0 0 0 0 0 0 0 0 0 0 0 0 0 0 0 0 0 0 54 0 41 6 40 0 
0 0 0 42 0 0 0 0 0 0 0 0 0 0 0 0 0 0 36 0 0 0 0 0 0 0 0 0 0 0 0 0 0 0 17 17 0 23 0 0 
0 0 0 0 0 0 0 0 0 0 0 0 0 0 0 0 0 0 0 0 0 0 0 38 53 0 0 0 0 0 0 0 0 0 43 0 0 0 0 0 
0 0 0 0 34 0 36 0 0 0 0 0 31 3 38 0 0 0 0 39 0 0 0 0 40 0 0 0 0 0 0 25 34 7 0 0 0 0 0 0 
0 0 33 0 6 27 0 0 0 6 0 33 0 0 0 0 11 0 0 0 32 0 0 0 0 0 0 0 0 0 21 0 42 0 0 0 0 0 0 0 
0 0 0 39 0 0 54 0 0 25 0 1 0 0 0 0 0 0 0 0 0 0 0 0 0 0 54 44 0 0 0 0 38 0 0 0 0 0 0 0 
0 0 6 0 0 0 0 0 0 0 42 17 27 0 0 0 0 0 0 0 0 0 0 0 0 1 0 10 0 0 56 0 39 0 0 0 0 0 0 0 
0 0 0 0 0 0 0 0 0 0 0 34 0 0 0 0 0 0 0 0 0 5 0 0 0 0 0 0 0 0 0 0 0 0 0 0 0 0 0 0 
0 0 42 0 0 0 0 0 0 0 0 0 0 0 0 0 0 0 0 0 0 4 0 0 0 0 0 25 0 0 0 0 0 0 0 0 0 0 0 0 