0 0 0 0 32 0 0 0 0 0 0 0 0 0 0 0 0 0 0 0 0 0 0 0 0 0 0 3 35 40 0 0 0 0 0 0 0 0 0 0 
0 0 0 0 2 0 0 0 0 0 0 0 0 0 0 0 0 0 0 0 0 0 0 0 0 0 0 0 45 0 33 0 0 0 0 0 0 0 0 0 
0 0 0 0 0 0 0 0 0 0 0 0 0 0 0 0 0 0 0 0 0 0 0 0 0 0 0 56 27 41 0 25 0 0 0 0 0 0 0 0 
0 0 0 0 0 0 0 0 0 0 0 0 0 0 0 31 12 0 0 0 0 0 0 0 0 0 0 0 37 0 10 0 0 0 0 0 0 0 0 0 
0 0 0 0 0 0 0 0 0 0 0 47 0 0 0 0 8 0 0 0 0 0 0 0 0 0 0 0 0 0 0 0 0 0 0 0 0 0 0 0 
0 0 0 0 0 0 0 0 0 0 0 38 0 0 0 0 0 0 0 0 0 0 0 0 0 0 0 0 0 38 0 0 0 6 40 36 0 0 0 0 
0 0 41 0 0 18 6 0 0 0 0 0 39 0 0 0 0 0 0 0 0 0 0 0 0 0 0 0 0 0 0 0 33 0 31 0 31 0 0 0 
0 0 0 2 0 28 0 0 0 0 0 0 0 0 0 0 0 0 2 0 0 0 0 0 0 0 0 0 57 18 0 0 0 0 0 0 0 0 0 0 
7 3 0 6 0 2 0 0 0 0 0 0 0 0 0 0 0 0 0 39 0 0 0 0 0 0 23 31 0 0 0 0 0 0 0 0 0 0 0 0 
33 0 36 0 44 0 25 0 0 0 0 0 0 0 0 0 0 0 0 0 0 0 0 0 0 0 0 0 0 0 0 0 0 0 0 0 0 0 0 0 
3 11 0 40 29 0 0 0 4 0 0 0 0 0 0 0 0 31 6 0 0 0 0 0 0 0 0 0 0 0 2 0 0 0 0 0 0 0 0 0 
0 0 0 0 0 13 0 0 0 0 46 0 0 0 24 0 0 0 35 0 41 0 0 50 57 0 0 0 0 0 0 0 0 0 0 0 0 0 0 0 
0 0 30 0 5 0 0 0 0 0 0 0 0 0 0 37 0 0 31 31 0 5 0 1 0 2 0 0 0 54 0 0 0 0 0 0 0 0 32 6 
0 17 0 0 0 0 0 0 0 42 33 0 0 0 34 5 0 2 34 0 6 0 0 0 0 0 0 0 0 0 0 0 20 0 0 0 0 0 38 0 
0 0 1 46 30 0 0 0 0 0 54 36 0 0 0 0 0 41 0 34 0 2 0 0 0 0 0 0 0 0 0 0 0 42 0 0 0 0 0 0 
11 27 0 0 0 0 0 0 0 0 6 0 39 0 0 0 0 0 5 0 41 0 0 0 0 0 0 0 0 0 0 0 0 0 0 0 0 0 0 0 
0 0 0 0 0 0 0 0 0 18 0 24 0 0 0 0 0 31 0 7 0 55 0 0 0 0 0 0 0 0 0 0 0 0 0 0 0 0 0 0 
0 0 0 0 0 6 4 0 40 0 0 32 31 0 0 0 0 5 0 0 22 0 0 0 0 0 0 0 0 0 0 0 0 0 0 0 0 0 0 0 
0 0 0 0 0 0 33 0 0 37 0 0 0 0 0 0 0 0 0 0 0 0 0 0 0 0 0 0 0 0 0 0 0 0 0 0 0 0 0 0 
0 0 0 0 0 32 0 0 0 0 57 30 33 0 0 0 0 0 0 0 0 4 0 0 0 0 0 0 0 0 0 0 0 0 0 0 0 0 0 0 
0 19 0 0 0 0 0 0 0 0 2 34 0 0 0 0 0 0 0 0 42 0 0 0 22 0 0 0 0 0 12 0 0 0 0 0 0 0 34 0 
0 0 0 0 0 34 0 0 0 8 0 0 0 0 0 0 0 0 0 0 0 0 0 0 1 38 12 0 0 0 2 20 0 0 0 0 0 0 0 0 
50 0 0 0 0 0 0 5 46 0 0 0 0 0 0 0 0 0 0 0 0 0 0 0 35 0 37 0 0 0 0 0 0 0 0 0 0 5 0 0 
0 0 38 0 0 0 0 0 6 0 0 0 0 0 0 0 0 0 0 0 0 0 0 0 32 41 0 0 0 0 0 0 0 0 0 0 20 0 0 0 
0 0 2 1 0 32 32 38 0 0 0 0 0 0 0 0 0 0 0 0 0 0 0 0 0 0 0 0 0 0 0 0 0 0 0 0 0 0 0 0 
0 0 0 0 0 0 0 0 0 0 0 7 0 0 0 0 0 0 0 0 0 0 0 0 0 0 0 0 0 0 0 35 0 0 0 0 0 0 0 0 
0 0 0 0 0 4 0 0 0 0 0 0 1 0 0 0 0 0 0 0 0 0 0 0 37 0 0 0 0 0 0 40 0 30 0 0 0 0 0 0 
0 0 0 0 0 0 33 0 0 0 0 0 0 0 0 0 0 0 0 0 0 0 0 0 0 0 0 0 0 0 0 0 39 54 0 0 0 0 0 0 
0 0 0 0 0 0 0 0 0 0 0 0 0 0 0 0 0 0 0 0 0 0 0 0 0 0 0 31 0 0 0 0 42 0 35 0 0 0 0 0 
0 0 0 0 0 0 0 0 0 0 0 0 0 0 0 0 0 0 0 0 0 0 0 0 0 0 37 54 0 0 0 0 33 6 0 0 0 0 0 0 
0 0 24 0 0 0 0 0 0 0 0 0 0 0 0 0 0 0 0 0 0 0 0 0 0 42 0 0 0 0 6 54 0 27 0 0 7 0 0 0 
28 0 6 0 0 0 0 0 0 0 0 0 0 0 0 0 0 0 0 0 0 0 0 0 0 0 1 0 0 1 0 22 0 0 0 17 40 0 0 0 
0 19 16 0 0 0 0 0 0 0 0 0 0 0 0 0 0 0 0 0 5 0 0 0 0 33 0 0 6 0 0 14 0 41 0 37 41 26 0 0 
1 0 0 0 0 0 0 0 0 0 0 0 0 0 0 0 0 0 0 0 0 0 0 0 0 0 42 34 0 15 0 0 39 0 36 0 34 0 24 0 
0 0 0 0 0 0 0 0 0 0 0 0 0 0 0 0 0 0 0 0 0 0 0 0 3 0 35 35 0 0 0 11 0 33 0 0 9 0 0 0 
0 0 0 0 0 0 0 0 0 0 0 0 0 0 0 0 0 0 0 16 42 0 0 0 26 0 15 0 4 26 37 43 0 0 31 0 0 0 0 0 
0 0 0 0 0 0 0 0 0 0 0 0 0 0 0 0 0 0 0 0 4 0 0 34 0 0 27 0 0 0 34 0 0 0 0 0 0 0 0 0 
0 0 0 0 0 0 0 0 0 0 0 0 0 0 0 0 0 0 0 0 0 0 0 0 0 0 0 0 0 0 0 41 0 32 40 0 0 0 0 0 
0 0 0 0 0 0 0 0 0 0 0 0 0 0 0 0 0 0 0 0 40 32 0 0 0 0 0 0 0 0 39 0 9 0 0 0 0 0 0 0 
0 0 0 0 0 0 0 0 0 0 0 0 0 0 0 0 0 0 0 26 0 38 0 0 0 0 0 0 0 0 0 40 0 0 0 0 0 0 33 0 