22 30 0 0 0 15 27 18 1 10 10 10 12 1 12 10 18 20 1 18 1 1 10 10 12 20 26 0 0 0 0 15 18 27 27 20 20 31 31 25 
5 25 0 0 0 1 22 1 1 27 20 12 27 27 1 12 1 20 27 20 20 12 27 12 12 8 0 0 0 0 0 0 22 20 12 1 1 10 1 8 
4 20 18 10 18 12 1 20 20 20 12 2 21 1 27 13 21 12 20 12 20 20 12 27 27 25 0 0 0 0 0 0 5 20 20 1 1 20 1 17 
28 12 27 20 20 20 12 20 27 12 8 0 0 28 25 0 0 4 12 20 20 12 1 12 20 12 10 29 0 0 0 14 20 20 1 20 12 12 27 17 
1 27 20 27 27 1 1 1 27 20 17 0 0 4 25 0 0 22 20 20 27 12 4 27 1 20 27 20 29 0 0 5 2 2 21 21 13 2 27 8 
5 1 13 13 2 2 2 27 20 1 8 0 0 5 25 0 0 22 12 12 20 20 1 27 27 20 20 1 17 0 0 7 0 0 0 0 0 0 5 2 
1 17 0 0 0 0 0 28 27 27 8 0 0 28 12 10 31 12 21 2 2 21 27 1 1 20 21 13 2 32 18 17 0 0 0 24 0 0 4 1 
6 26 0 0 0 0 0 28 1 27 1 18 31 1 12 1 12 25 0 0 0 0 5 27 1 25 0 0 0 0 22 1 8 18 31 20 18 18 1 16 
0 0 0 0 0 0 0 5 1 1 20 1 12 27 20 12 27 25 0 0 0 0 4 12 27 16 0 0 0 0 28 27 27 20 12 20 27 20 27 2 
0 0 0 0 0 0 0 28 2 2 21 20 12 27 27 12 12 13 32 11 11 31 1 12 12 27 18 18 31 32 21 27 1 27 1 12 27 12 17 0 
0 0 0 0 0 0 14 16 0 0 0 28 27 12 21 21 17 0 0 0 0 6 27 2 13 13 20 27 16 0 0 28 12 27 12 27 27 12 25 0 
0 0 0 0 0 0 5 16 0 0 0 28 27 17 0 0 23 0 0 0 0 0 23 0 0 0 28 20 8 0 0 28 20 12 12 1 27 20 21 32 
0 0 0 0 0 0 5 20 10 11 11 2 20 25 0 0 7 0 0 0 0 0 7 0 0 0 22 12 17 0 0 4 2 13 20 20 20 16 0 0 
0 0 0 0 0 15 12 20 16 0 0 0 6 16 0 0 7 0 0 0 0 15 20 18 18 31 27 12 27 10 18 17 0 0 28 27 27 16 0 0 
0 0 0 0 0 0 28 1 25 0 0 0 0 4 18 31 25 0 0 0 0 0 22 27 1 20 27 27 1 12 20 25 0 0 4 12 20 12 18 18 
0 0 0 0 0 0 4 20 25 0 0 0 0 28 27 27 25 0 0 0 0 0 5 20 20 27 20 20 12 12 12 1 31 10 1 12 20 12 12 12 
31 31 18 31 18 19 21 2 26 0 0 0 0 4 27 12 17 0 0 0 0 0 28 12 12 20 1 27 27 20 1 20 1 20 27 12 1 1 1 29 
4 20 27 1 16 0 0 0 0 0 0 0 0 22 1 27 25 0 0 0 0 0 22 27 1 12 20 1 20 12 27 27 1 12 1 1 20 1 1 25 
13 2 1 1 17 0 0 0 0 0 0 0 0 4 6 20 20 10 27 0 0 0 22 20 12 1 12 27 20 3 12 1 1 20 20 1 1 1 12 8 
0 0 22 1 16 0 0 0 0 0 0 0 0 5 12 27 1 12 17 0 0 0 4 20 13 2 13 12 1 12 2 13 20 20 1 31 20 2 13 16 
0 0 28 1 25 0 0 0 0 0 0 0 14 12 12 1 12 12 8 0 0 0 4 17 0 0 0 4 20 16 0 0 22 27 12 20 16 0 0 5 
15 11 1 12 17 0 0 0 0 0 14 31 20 27 20 1 12 20 1 18 31 31 20 17 0 0 0 5 20 8 0 0 28 1 12 20 26 0 0 7 
0 0 6 13 25 0 0 0 0 14 1 20 27 12 20 12 1 20 1 20 27 12 1 16 0 0 0 22 1 20 18 31 20 27 12 25 0 0 0 28 
0 0 0 0 7 0 0 0 0 22 1 20 27 1 27 12 20 12 20 20 27 20 12 25 0 0 0 22 20 20 1 27 12 20 20 8 0 0 0 22 
0 0 0 0 23 0 0 0 0 4 12 21 2 20 27 20 1 27 1 27 20 1 12 2 32 18 31 20 12 27 1 2 21 13 12 17 0 0 0 28 
10 10 18 31 20 19 19 31 18 27 16 0 0 4 20 1 27 20 1 1 27 1 16 0 0 28 18 20 27 12 25 0 0 0 28 1 18 10 10 8 
12 20 27 12 8 0 0 4 12 12 8 0 0 4 20 20 1 27 1 1 12 1 16 0 0 28 1 12 20 1 8 0 0 0 22 20 1 20 1 28 
27 20 27 27 25 0 0 28 12 27 27 31 10 12 1 12 12 27 1 20 20 12 16 0 0 4 2 21 1 12 16 0 0 0 6 27 12 20 27 25 
27 27 1 20 1 18 18 1 20 12 4 27 1 27 12 20 20 27 27 12 20 12 27 18 31 26 0 0 4 20 17 0 0 0 0 4 3 20 12 4 
4 13 2 12 1 20 20 27 27 20 1 20 12 1 20 27 27 1 20 20 1 20 1 27 16 0 0 0 22 21 2 30 0 0 0 6 2 2 27 27 
26 0 0 4 12 1 27 27 20 12 27 12 1 12 27 27 20 20 1 20 12 12 27 27 17 0 0 15 26 0 0 0 0 0 0 0 0 0 6 17 
0 0 0 5 20 27 20 20 27 20 1 20 20 28 20 1 1 1 27 27 2 13 12 12 16 0 0 0 0 0 0 0 0 0 0 0 0 0 0 5 
0 0 0 5 12 27 12 27 27 20 12 12 27 27 1 20 12 20 27 8 0 0 22 20 25 0 0 0 0 0 0 0 0 0 0 0 0 0 0 22 
0 0 0 22 27 20 12 1 1 12 1 27 20 1 12 27 27 1 20 17 0 0 28 2 21 30 0 0 0 0 0 0 0 0 0 24 0 0 0 14 
31 10 31 12 20 20 12 27 12 12 1 1 1 27 12 1 27 20 20 13 11 31 25 0 0 0 0 0 0 0 0 0 0 0 0 23 0 0 0 19 
20 27 12 20 27 27 27 4 12 1 1 1 12 1 12 1 27 27 8 0 0 5 8 0 0 0 0 0 0 0 0 0 0 0 0 5 18 31 10 17 
4 1 27 20 1 20 1 12 20 12 1 20 20 12 26 27 20 12 8 0 0 5 16 0 0 0 0 0 0 0 0 15 19 30 0 4 1 1 1 17 
12 12 20 28 12 1 20 27 12 1 27 12 1 20 12 27 12 20 12 19 19 13 20 10 18 18 10 31 31 10 30 0 0 0 0 4 12 13 2 16 
20 27 1 20 20 27 20 20 20 27 27 12 20 27 27 27 20 27 8 0 0 0 5 27 20 1 20 12 1 17 0 0 0 14 31 27 17 0 0 28 
4 13 1 13 12 20 20 21 1 2 2 21 27 12 13 13 2 13 26 0 0 0 4 20 13 1 27 12 2 25 0 0 0 22 17 2 17 0 0 6 