0 0 6 10 18 27 27 31 12 12 18 27 12 1 1 1 18 10 29 0 0 0 0 4 10 16 0 0 0 0 0 0 0 0 0 0 0 28 29 0 
0 0 0 28 12 1 20 12 12 12 20 20 12 27 27 2 2 12 25 0 0 0 0 5 1 17 0 0 0 0 0 0 0 0 0 0 0 28 8 0 
0 0 0 6 13 20 27 12 27 20 20 20 27 1 16 0 0 22 8 0 9 0 0 5 1 12 31 29 0 0 0 0 0 0 0 0 0 5 12 11 
0 0 0 0 0 6 13 20 20 12 12 1 21 21 17 0 0 4 16 0 0 0 0 5 12 1 1 27 29 0 0 0 0 0 14 10 18 20 26 0 
0 0 0 0 0 0 0 22 27 13 2 25 0 0 5 10 10 8 17 0 0 0 0 4 27 12 27 12 12 18 10 29 0 0 18 20 12 26 0 0 
0 0 0 0 0 0 0 5 17 0 0 7 0 0 22 20 12 20 22 10 29 0 0 5 1 27 1 12 20 27 12 27 10 10 12 2 26 0 0 0 
0 0 0 0 0 0 0 28 25 0 0 7 0 0 5 1 1 27 27 1 25 0 0 22 20 1 20 12 1 11 27 27 1 20 8 0 0 0 0 0 
0 0 0 0 0 0 0 28 1 32 32 12 18 31 1 20 20 27 13 21 2 10 31 20 1 29 1 27 27 12 20 20 27 1 26 0 0 0 0 0 
0 0 0 0 0 0 15 27 25 0 0 4 1 2 20 13 21 16 0 0 0 4 20 1 1 20 12 1 12 12 27 22 1 25 0 0 0 0 0 0 
0 0 0 0 0 0 0 5 26 0 0 28 12 3 7 0 0 23 0 0 0 22 12 27 1 1 1 17 27 1 1 12 27 8 0 0 0 0 0 0 
0 24 0 0 0 0 0 23 0 0 0 28 20 18 16 0 0 23 0 0 0 28 21 13 12 20 27 27 12 12 1 20 20 8 0 0 24 0 0 0 
0 23 0 0 0 0 0 7 0 0 15 1 20 27 20 10 18 25 0 0 0 7 0 0 23 5 1 12 20 20 20 1 1 12 11 32 8 0 0 0 
0 7 0 0 0 14 18 16 0 0 0 6 12 12 20 1 20 13 26 19 11 8 0 0 0 4 20 1 21 2 20 1 1 25 0 0 4 10 29 0 
0 23 0 0 0 5 1 8 0 0 0 0 4 12 27 27 8 0 0 0 0 23 0 0 0 5 1 17 0 0 28 12 27 17 0 0 5 1 12 29 
27 27 31 31 18 1 1 25 0 0 0 0 22 12 1 1 2 0 0 0 0 4 31 31 18 1 1 16 0 0 6 27 1 20 31 31 12 12 20 1 
13 21 2 21 20 27 12 16 0 0 14 18 12 12 20 1 8 0 0 0 0 28 20 27 1 12 27 8 0 0 0 4 12 12 1 27 27 12 20 25 
0 0 0 0 28 1 12 1 18 10 27 1 20 27 11 12 12 18 18 31 19 21 21 13 27 12 20 27 30 0 0 4 1 20 1 12 12 20 20 2 
0 0 0 0 6 27 6 27 12 1 12 1 12 1 21 2 13 27 12 16 0 0 0 0 5 20 13 26 0 0 0 6 13 2 27 20 1 1 16 0 
0 0 0 0 0 28 1 1 27 12 27 13 13 16 0 0 0 6 2 26 0 0 0 0 4 16 0 0 0 0 0 0 0 0 4 12 27 27 26 0 
0 0 24 0 0 22 1 1 27 1 17 0 0 23 0 0 0 0 0 0 0 24 0 0 28 8 0 0 0 0 0 0 0 0 5 1 27 26 0 0 
27 10 27 31 10 20 1 1 1 27 16 0 0 4 31 31 18 29 0 0 0 5 29 0 6 21 30 0 0 0 0 0 0 0 22 12 17 0 0 0 
2 20 1 1 20 12 1 27 12 1 25 0 0 4 27 1 12 20 31 10 31 12 17 0 0 0 0 0 0 0 0 0 0 0 22 13 17 0 0 0 
0 22 12 12 20 27 20 27 27 12 27 31 25 1 13 2 20 27 1 27 1 12 25 0 0 0 0 0 0 0 0 0 0 0 22 26 22 31 29 0 
0 28 1 27 20 20 27 1 12 12 20 12 1 25 0 0 5 20 27 27 20 20 8 0 0 0 0 0 0 0 0 0 0 14 20 20 12 12 16 0 
0 4 1 12 20 12 1 12 1 21 21 13 12 8 0 0 22 27 12 20 20 5 8 0 0 0 0 0 0 0 0 0 0 28 27 27 12 20 20 31 
10 27 1 12 12 1 25 27 25 0 0 0 4 8 0 0 22 1 1 27 1 27 1 19 30 0 0 0 0 0 0 0 0 28 12 27 20 12 20 12 
6 20 20 12 1 1 1 20 16 0 0 0 4 12 18 10 1 27 1 27 20 1 8 0 0 0 0 0 9 0 0 0 0 5 12 1 1 20 20 20 
28 1 20 27 11 12 1 1 20 32 19 31 20 12 2 13 12 21 27 20 1 1 8 0 0 0 0 0 0 0 0 0 0 6 12 20 1 20 20 1 
32 1 27 20 1 1 20 12 8 0 0 5 20 25 0 0 5 27 20 1 12 20 16 0 0 0 0 0 0 0 0 0 0 0 28 20 20 27 12 27 
6 12 1 27 12 1 20 20 17 0 0 5 20 8 0 0 4 20 13 2 1 1 12 31 10 29 0 0 0 24 0 0 0 0 6 13 21 2 2 16 
12 27 1 27 12 27 22 12 20 10 10 20 2 1 10 18 27 25 0 0 28 12 12 27 27 8 0 0 0 5 29 0 0 0 0 0 0 0 0 6 
27 27 2 2 12 27 1 1 12 27 12 12 2 22 1 20 27 25 0 0 5 1 3 27 1 12 18 31 18 1 20 31 8 0 0 0 0 0 0 31 
27 25 0 0 28 27 1 1 1 12 20 27 19 13 2 12 20 25 0 0 4 20 1 21 13 27 1 20 3 12 27 12 17 0 0 0 0 0 0 5 
28 16 0 0 6 2 21 1 27 21 21 26 0 0 0 5 13 21 19 19 13 27 8 0 0 28 20 1 1 20 2 13 26 0 0 14 18 10 10 27 
10 17 0 0 0 0 0 5 17 0 0 0 0 0 0 23 0 0 0 0 0 28 16 0 0 4 13 1 12 16 0 0 0 0 0 4 20 1 12 25 
31 8 0 0 0 0 0 4 16 0 0 0 15 19 32 17 0 0 0 0 0 5 12 18 18 21 21 13 27 8 0 0 0 14 10 12 12 12 27 12 
5 25 0 0 0 0 0 6 8 0 0 0 0 0 0 22 31 31 1 10 18 1 1 1 8 0 0 0 5 25 0 0 0 28 27 12 20 12 20 12 
17 16 0 0 0 0 0 0 23 0 0 0 0 0 0 4 12 27 12 5 2 21 12 1 8 0 0 0 28 16 0 0 0 4 8 12 27 1 27 1 
5 8 0 0 0 0 0 0 23 0 0 0 0 0 14 27 1 12 27 17 0 0 5 27 27 29 0 0 22 27 10 31 10 20 1 27 1 20 1 1 
20 25 0 0 14 32 18 19 21 11 19 19 10 31 13 27 27 1 13 16 0 0 4 27 21 16 0 0 6 13 12 13 20 21 2 27 21 2 20 2 