0 0 22 12 32 1 31 12 12 10 12 10 27 18 12 1 27 20 18 27 18 1 27 10 27 27 1 10 10 25 27 1 12 31 31 10 14 1 27 8 
0 0 28 1 27 27 1 12 27 27 12 18 10 21 2 1 12 12 27 20 1 27 27 27 12 20 12 13 13 13 12 20 20 20 27 12 1 12 20 17 
10 31 27 20 20 27 21 13 2 27 12 1 8 0 0 4 12 27 2 2 1 1 12 1 1 1 8 0 0 0 22 12 1 27 20 27 12 27 20 20 
27 1 12 20 12 25 0 0 0 5 27 1 16 0 0 6 2 26 0 0 5 20 12 20 20 1 16 0 0 0 28 20 1 20 12 13 13 20 20 27 
1 27 27 20 1 16 0 0 0 5 27 27 16 0 0 0 0 0 0 0 4 14 20 1 12 1 20 31 10 18 1 20 27 1 16 0 0 5 20 14 
12 20 27 2 2 2 31 31 18 27 20 20 8 0 0 0 0 0 14 18 27 1 13 21 21 27 27 1 13 21 21 20 12 12 25 0 0 4 7 20 
31 12 8 0 0 0 5 12 1 20 27 20 20 10 18 31 10 18 12 2 13 26 0 0 0 5 21 26 0 0 0 4 20 12 20 18 10 1 12 17 
28 1 25 0 0 0 22 12 20 12 1 27 20 20 12 20 27 20 8 0 0 0 0 0 0 23 0 0 0 0 0 22 27 12 20 12 27 20 1 1 
4 1 8 0 0 0 4 27 1 20 2 13 21 2 21 27 1 1 8 0 0 0 0 14 10 16 0 0 0 0 0 22 1 16 12 1 12 27 27 13 
12 12 12 31 10 18 12 12 12 25 0 0 0 0 0 4 27 1 27 18 18 18 18 20 12 25 0 0 0 14 31 1 27 20 12 27 20 20 12 27 
28 1 12 12 27 27 1 27 1 8 0 0 24 0 0 17 20 27 27 27 12 27 1 12 27 2 32 31 31 13 13 13 1 12 2 21 13 13 2 2 
13 2 20 12 1 20 20 20 20 31 32 32 13 10 18 1 2 21 1 12 12 20 27 27 25 0 0 5 25 0 0 0 22 17 0 0 0 0 0 0 
0 0 28 1 12 1 12 27 20 8 0 0 0 4 12 25 0 0 22 20 12 27 12 12 16 0 0 22 17 0 0 0 22 16 0 0 0 0 0 0 
0 0 28 27 20 20 20 20 20 17 0 0 0 28 12 25 0 0 6 21 2 2 21 12 8 0 0 28 25 0 0 0 4 17 0 0 0 0 0 0 
0 0 22 1 12 12 12 1 27 16 0 0 0 22 20 8 0 0 0 0 0 0 0 5 1 18 18 27 12 29 0 0 4 27 29 0 0 0 0 3 
0 0 22 12 12 20 1 2 2 13 11 32 31 27 27 8 0 0 0 0 0 0 0 21 12 27 12 2 13 13 32 19 13 2 27 29 0 0 0 22 
0 14 1 1 1 1 25 0 0 0 0 0 5 12 1 16 0 0 0 0 0 15 10 27 12 1 26 0 0 0 0 0 0 0 5 27 11 19 19 13 
0 22 12 20 12 27 25 0 0 0 0 0 6 13 21 13 31 18 31 29 0 0 6 1 27 8 0 0 0 0 0 0 0 0 4 16 0 0 0 0 
0 4 12 1 1 20 17 0 0 0 0 0 0 0 0 0 5 20 1 16 0 0 0 4 1 16 0 0 24 0 0 0 0 0 28 16 0 0 0 0 
13 20 20 12 27 1 17 0 0 0 0 0 0 0 0 0 4 20 20 25 0 0 0 28 1 27 10 18 25 0 0 0 0 14 12 17 0 0 0 1 
4 27 12 1 12 12 16 0 0 0 0 0 0 14 32 32 12 25 1 8 0 0 14 1 1 12 12 27 16 0 0 0 0 28 12 16 0 0 0 0 
6 2 2 1 20 27 13 11 31 31 18 18 18 25 0 0 22 20 12 1 18 10 1 27 12 18 20 1 20 29 0 0 14 27 27 8 0 0 0 0 
0 0 0 5 12 25 0 0 28 20 12 20 31 12 0 0 4 12 12 27 20 12 12 1 1 13 21 31 1 20 18 18 21 13 12 3 18 10 31 18 
0 0 0 5 6 8 0 0 28 21 21 12 27 25 0 0 28 1 21 21 2 1 12 27 16 0 0 0 28 27 20 8 0 0 1 1 1 1 27 12 
22 0 0 4 20 12 10 10 8 0 0 4 1 8 0 0 28 17 0 0 0 5 12 1 17 0 0 0 28 27 1 17 0 0 28 20 12 1 20 1 
14 18 31 20 27 24 12 12 17 0 0 4 21 21 18 31 21 26 0 0 0 5 20 1 27 10 31 10 1 12 27 17 0 0 6 20 27 12 12 16 
5 2 2 2 1 27 20 12 12 31 10 26 0 0 28 25 0 0 14 10 31 20 20 13 21 12 1 27 21 13 13 25 0 0 0 4 12 27 20 8 
10 0 0 0 6 2 20 1 12 1 17 0 0 0 4 25 0 0 5 1 8 12 25 0 0 6 20 8 0 0 0 6 30 0 0 28 12 12 20 17 
15 0 0 0 0 0 28 12 20 20 8 0 0 0 28 20 10 31 20 2 21 20 8 0 0 0 28 16 0 0 0 0 0 0 0 22 12 1 27 1 
6 29 0 0 0 0 12 12 20 20 16 0 0 0 28 20 1 12 16 0 0 28 16 0 0 0 5 25 0 0 14 18 10 31 10 12 1 12 1 25 
16 1 10 18 31 31 27 21 21 1 17 0 14 10 20 27 18 12 16 0 0 28 12 28 10 10 27 8 0 0 28 12 21 13 2 1 1 27 12 8 
12 1 1 12 27 12 17 0 0 28 8 0 22 20 1 12 1 1 12 31 31 3 20 10 1 27 12 13 32 11 1 25 0 0 0 6 12 20 1 20 
5 1 20 27 1 12 16 0 0 22 8 0 28 1 20 12 12 27 12 27 12 12 1 12 27 12 26 0 0 0 28 16 0 0 0 0 22 27 1 8 
22 12 1 12 1 1 27 18 31 1 25 0 22 20 12 1 27 20 1 12 25 23 4 1 12 8 0 0 0 0 5 17 0 0 0 0 5 20 12 17 
4 20 27 12 2 2 20 1 12 27 25 0 6 2 12 1 12 12 20 27 27 10 2 2 1 16 0 0 0 0 5 16 0 0 0 0 22 1 1 16 
20 27 1 16 0 0 6 21 20 27 16 0 0 0 5 27 12 12 2 21 27 8 0 0 28 23 29 0 0 0 4 27 32 19 18 18 12 1 20 8 
12 27 27 17 0 0 0 0 5 20 8 0 0 0 22 20 31 26 0 0 5 17 0 0 4 27 8 0 0 0 5 17 0 0 5 20 20 12 12 13 
12 22 27 8 0 0 0 0 22 1 25 0 0 0 4 27 16 0 0 0 22 27 31 10 20 1 27 18 31 18 20 16 0 0 6 2 2 1 8 0 
0 22 12 1 10 31 31 31 20 1 8 0 0 0 5 12 25 0 0 0 5 27 27 20 1 20 1 20 12 1 12 16 0 0 0 0 0 4 25 0 
0 4 12 21 2 2 21 20 27 1 5 31 10 32 12 2 13 10 32 31 21 12 12 2 21 20 2 1 2 21 12 2 18 29 0 0 0 5 10 30 