1 8 0 0 0 0 0 4 31 12 27 1 18 10 25 0 0 28 31 16 
20 8 0 0 0 0 0 22 20 13 21 27 12 1 16 0 0 5 27 20 
5 1 18 18 31 11 19 27 26 0 0 4 27 1 16 0 0 5 12 27 
27 1 27 1 17 0 0 23 0 0 0 28 20 27 17 0 0 5 1 12 
27 12 20 1 18 0 0 23 0 0 0 4 27 12 25 0 0 22 12 1 
20 20 20 27 27 18 19 13 10 18 18 1 1 27 1 18 18 27 20 16 
28 12 1 1 1 25 0 0 28 20 20 12 20 27 27 20 20 1 27 8 
22 3 12 27 12 16 0 0 28 1 13 2 21 27 12 12 20 1 20 20 
5 12 1 12 12 16 0 0 22 25 0 0 0 22 27 12 21 27 27 20 
21 2 13 27 1 1 18 31 27 16 0 0 0 4 12 12 20 1 1 26 
0 0 0 4 27 20 27 12 27 12 18 3 10 20 27 20 27 20 16 0 
0 0 0 4 12 12 20 21 2 2 12 12 20 27 27 1 20 20 25 0 
0 0 0 28 13 2 16 0 0 0 22 1 20 20 20 20 20 12 1 31 
0 0 14 25 0 0 23 0 0 0 22 12 20 12 27 13 2 13 2 27 
18 10 27 25 0 0 5 10 31 18 12 20 1 12 25 0 0 0 0 20 
12 5 27 25 0 0 4 12 1 20 21 13 27 27 8 0 0 0 0 21 
27 20 20 17 0 0 5 1 27 25 0 0 28 27 27 31 18 18 31 25 
28 27 12 25 0 0 5 27 1 8 0 0 22 20 27 20 20 1 1 1 
28 12 12 27 31 31 1 27 1 25 0 0 28 1 12 12 27 27 12 25 
22 1 13 2 13 12 2 20 21 12 19 31 2 12 27 27 2 1 12 27 