27 31 1 17 0 0 0 0 7 0 0 0 0 0 0 0 0 0 0 5 
27 12 12 17 0 0 0 0 23 0 0 0 9 0 0 0 0 0 0 7 
27 20 27 25 0 0 14 31 26 0 0 0 0 0 0 0 0 0 14 8 
5 20 13 21 32 32 21 16 0 0 0 0 0 0 0 0 0 0 5 25 
4 17 0 0 0 0 0 7 0 0 0 0 0 0 0 0 0 0 28 8 
22 8 0 0 0 0 0 7 0 0 0 0 0 0 0 0 0 0 5 8 
1 25 0 0 0 0 0 4 29 0 0 0 0 0 0 0 0 15 20 1 
5 8 0 0 0 0 0 22 17 0 0 0 0 0 0 0 0 0 6 21 
1 17 0 0 0 0 0 4 17 0 0 0 0 0 0 0 0 0 0 0 
14 8 0 0 0 0 15 21 6 18 29 0 0 0 0 0 0 0 0 0 
5 8 0 0 0 0 0 0 28 20 16 0 0 0 0 0 0 0 0 14 
28 2 32 10 10 29 0 0 5 20 16 0 0 0 0 9 0 0 0 7 
25 0 0 22 20 1 31 18 12 27 17 0 0 0 0 0 0 0 14 20 
23 0 0 22 16 13 21 27 12 1 16 0 0 0 0 0 0 15 12 18 
28 18 31 27 16 0 0 6 2 27 8 0 0 0 0 0 0 0 5 25 
20 28 20 27 17 0 0 0 0 22 16 0 0 0 24 0 0 0 22 12 
1 12 12 12 17 0 0 0 0 5 25 0 0 0 5 18 10 10 20 20 
1 12 27 12 17 0 0 0 14 12 16 0 0 15 27 1 12 2 13 8 
1 1 27 20 20 10 10 31 27 1 12 29 0 0 4 20 8 0 0 5 
22 27 20 20 27 20 2 1 13 21 20 8 0 0 6 14 17 0 0 28 