4 10 27 31 10 10 31 12 18 12 12 27 26 0 0 0 0 5 1 10 27 31 18 1 10 31 1 12 31 27 18 17 0 0 28 20 27 1 18 18 
27 1 27 12 13 21 2 20 1 1 1 25 0 0 0 0 0 22 12 22 12 1 20 27 12 12 18 27 18 20 12 25 0 0 4 12 1 13 21 25 
5 27 27 17 0 0 0 5 12 1 27 25 0 0 0 0 0 28 20 1 27 20 12 1 12 1 12 20 20 1 1 16 0 0 4 12 25 0 0 5 
28 12 27 6 0 0 0 4 4 27 27 16 0 0 0 0 0 5 12 21 13 21 20 27 31 1 27 20 1 12 27 20 31 10 27 27 16 0 0 20 
27 27 27 12 10 10 18 27 12 17 20 16 0 0 0 0 0 22 8 0 0 0 6 13 5 13 27 20 1 1 13 21 21 20 20 1 12 31 18 17 
28 27 1 21 21 2 20 12 12 27 27 25 0 0 0 0 0 4 25 0 0 0 0 0 0 0 4 12 2 26 0 0 0 28 27 20 12 27 18 16 
19 27 25 0 0 0 22 27 1 27 12 25 0 0 0 0 0 5 17 0 0 0 0 0 0 0 22 16 0 0 0 0 0 5 20 12 20 12 13 26 
1 20 17 0 0 0 5 20 12 1 13 21 19 32 30 0 0 22 6 29 0 0 0 0 0 0 28 25 0 0 0 0 14 20 20 1 20 17 0 0 
28 20 16 0 0 0 4 27 20 17 0 0 0 0 0 0 0 22 12 8 0 0 24 0 0 0 28 12 18 29 0 0 22 27 27 20 20 16 0 0 
26 1 8 0 0 0 5 12 27 17 0 0 0 0 0 15 11 1 29 20 31 31 27 29 0 0 4 12 20 12 18 31 1 12 13 13 20 17 0 0 
22 20 21 19 32 19 27 20 20 8 0 0 0 0 0 0 0 22 27 1 20 27 27 25 0 0 22 1 12 27 20 20 20 17 0 0 4 21 0 32 
28 17 0 0 0 0 6 12 1 25 0 0 0 0 0 0 0 22 27 1 13 13 20 17 0 0 28 1 27 27 20 20 12 17 0 0 4 17 0 0 
28 17 0 0 24 0 0 28 12 2 32 30 0 0 0 0 0 5 20 8 0 0 28 16 0 0 4 12 1 20 12 20 27 27 10 18 12 25 0 0 
2 2 19 19 26 0 0 4 8 0 0 0 0 0 0 0 0 22 20 8 0 0 28 1 19 11 2 2 13 1 20 27 20 13 21 12 14 16 0 0 
0 0 0 0 0 0 0 22 8 0 0 0 0 0 0 14 31 20 27 12 10 10 1 25 0 0 0 0 0 28 20 12 16 0 0 5 20 20 18 10 
0 0 0 0 0 0 0 6 16 0 0 0 0 0 0 22 27 12 27 27 1 1 1 16 0 0 0 0 0 4 1 27 17 0 0 28 20 12 20 17 
31 0 0 0 0 0 0 0 23 0 0 0 0 0 0 22 27 1 27 2 21 13 20 8 0 0 0 0 0 5 12 27 1 18 31 1 20 20 1 23 
0 0 0 9 0 0 0 0 23 0 0 0 0 14 18 12 12 27 25 0 0 0 22 27 11 19 11 11 19 21 13 2 21 20 1 1 12 20 20 17 
0 0 0 0 0 0 0 0 22 29 0 0 0 5 2 1 12 27 8 0 0 0 22 25 0 0 0 0 0 0 0 0 0 6 12 12 12 27 12 8 
19 0 0 0 0 24 0 0 4 17 0 0 0 4 27 20 27 27 17 0 0 0 28 26 0 0 0 0 0 0 0 0 0 0 5 1 12 20 27 1 
1 18 29 0 0 4 31 18 27 21 19 19 18 1 27 20 12 20 20 18 18 31 16 0 0 0 0 0 0 0 0 0 0 0 4 20 12 1 12 13 
21 12 25 0 0 22 12 12 16 0 0 0 5 1 12 1 12 20 1 12 20 20 16 0 0 0 0 0 0 0 0 0 0 0 22 20 27 20 25 0 
0 4 27 31 31 12 27 27 17 0 0 0 22 12 1 20 20 20 20 21 2 27 17 0 0 24 0 0 0 14 10 31 31 18 1 26 12 5 17 0 
0 28 2 2 12 1 20 20 12 18 31 18 20 20 27 2 2 2 8 0 0 22 21 19 19 8 0 0 0 22 3 12 27 1 25 0 0 4 12 31 
10 16 0 0 4 20 12 12 20 20 2 2 27 27 25 0 0 0 23 0 0 23 0 0 0 23 0 0 14 12 12 27 27 12 25 0 0 22 12 17 
25 17 0 0 4 1 27 12 12 17 0 0 6 21 25 0 0 0 7 0 0 23 0 0 0 5 10 10 1 12 1 1 12 27 17 0 0 5 12 27 
3 27 31 31 20 12 1 27 20 17 0 0 0 0 22 29 0 0 7 0 0 7 0 0 0 5 27 20 20 27 1 1 20 20 1 18 18 1 12 20 
27 12 12 20 12 27 20 12 27 27 10 29 0 0 28 20 10 10 27 18 18 17 0 0 0 4 20 27 27 12 12 1 27 12 12 27 12 1 20 20 
22 27 20 1 12 27 20 12 12 27 20 13 19 10 1 1 20 1 1 27 1 12 18 31 31 27 12 27 12 1 20 12 20 12 20 12 12 13 13 1 
27 12 27 20 12 12 27 27 1 20 16 0 0 22 13 21 13 2 20 27 1 27 27 27 12 1 20 20 13 13 21 21 1 27 27 27 17 0 0 23 
27 27 12 20 1 12 14 20 12 12 16 0 0 7 0 0 0 0 22 27 1 27 12 1 1 20 1 25 0 0 0 0 28 1 27 1 8 0 0 5 
4 20 20 13 13 20 27 12 1 12 1 29 0 23 0 0 0 0 28 20 12 27 13 8 1 1 20 8 0 0 0 0 4 1 27 12 12 18 18 13 
6 1 25 0 0 4 20 27 1 1 13 26 0 7 0 0 0 14 1 2 2 2 2 21 2 21 21 6 31 10 31 10 27 27 1 13 2 13 8 0 
0 4 16 0 0 28 27 1 12 17 0 0 0 4 10 10 18 27 8 0 0 0 0 0 0 0 0 22 2 2 20 12 21 13 8 0 0 0 7 0 
0 6 17 0 0 28 13 21 1 26 0 0 0 28 27 27 1 1 8 0 0 0 0 0 0 0 0 7 0 0 4 17 0 0 7 0 0 0 7 0 
0 0 7 0 0 23 0 0 22 20 19 11 11 2 21 21 27 27 17 0 0 24 0 0 0 0 0 7 0 0 4 16 0 0 6 29 0 0 28 29 
0 0 5 18 18 16 0 0 28 8 0 0 0 0 0 0 5 1 1 19 19 17 0 0 0 0 0 4 31 18 20 25 0 0 0 28 18 10 20 20 
19 31 20 27 1 25 0 0 4 8 0 0 0 0 0 0 5 27 25 0 0 22 29 0 0 0 0 28 1 12 27 8 0 0 0 22 20 27 20 27 
19 4 20 20 27 17 0 0 5 1 29 0 0 0 0 0 5 1 17 0 0 22 25 0 0 0 0 28 1 20 20 20 18 18 31 1 27 1 12 20 
15 2 12 1 21 16 0 0 28 2 13 30 0 0 0 0 5 13 12 19 32 2 20 10 32 31 31 12 12 27 27 13 27 21 1 30 27 27 2 13 