14 1 10 27 31 27 8 0 0 0 0 0 0 0 0 14 8 0 0 0 0 0 0 0 0 
5 20 12 1 1 27 25 0 0 0 0 24 0 0 0 4 16 0 0 0 0 0 0 0 0 
13 1 27 1 1 1 27 10 18 11 19 1 18 10 10 1 8 0 0 0 0 0 0 0 0 
0 5 12 12 27 1 20 20 25 0 0 22 27 12 27 20 12 18 31 31 29 0 0 0 0 
0 4 27 1 20 27 20 12 25 0 0 4 20 20 20 1 27 1 1 20 1 29 0 0 0 
14 27 20 12 1 20 20 12 27 18 10 20 20 20 12 12 12 27 12 27 12 27 31 10 31 
1 27 1 27 27 12 20 27 20 21 2 21 13 2 12 27 20 27 12 27 1 27 20 20 25 
27 12 27 12 12 12 20 1 8 0 0 0 0 0 5 1 20 20 12 1 13 2 13 13 26 
27 1 20 20 1 20 12 27 25 0 0 0 0 0 22 27 27 1 2 26 0 0 0 0 0 
5 12 27 12 12 1 1 1 17 0 0 0 0 0 28 20 12 16 0 0 0 9 0 0 0 
28 12 1 12 1 2 13 21 2 30 0 0 0 0 5 27 20 25 0 0 0 0 0 0 0 
4 20 13 13 26 0 0 0 0 0 0 0 0 0 5 27 27 17 0 0 0 0 15 18 31 
27 16 0 0 0 0 0 0 24 0 0 0 0 0 4 20 20 8 0 0 0 0 0 5 27 
20 16 0 0 0 0 0 14 27 29 0 0 0 0 4 12 20 8 0 0 0 0 0 28 17 
1 8 0 0 0 0 0 4 12 25 0 0 0 0 28 12 27 12 29 0 0 15 11 13 13 
2 26 0 0 0 0 0 4 20 25 0 0 0 0 5 12 1 1 27 29 0 0 0 0 0 
0 0 0 0 0 0 0 28 1 12 31 31 10 18 27 20 27 20 1 17 0 0 0 0 0 
0 0 0 0 0 0 0 28 20 12 20 20 20 27 1 20 1 27 27 20 18 11 30 0 0 
0 0 0 0 0 0 0 4 1 13 13 27 20 12 1 20 12 1 12 20 16 0 0 0 0 
0 0 0 0 0 0 0 5 8 0 0 5 1 27 20 2 21 13 12 20 8 0 0 0 0 
0 0 0 0 0 0 14 20 8 0 0 4 20 12 17 0 0 0 22 27 17 0 0 0 0 
0 0 0 0 0 0 28 20 1 18 10 13 13 12 16 0 0 0 22 12 16 0 0 0 24 
0 0 0 0 0 0 4 12 1 12 17 0 0 4 12 29 0 0 4 1 17 0 0 0 28 
0 0 0 0 0 0 22 20 20 20 16 0 0 22 1 12 10 31 1 1 1 18 18 18 17 
0 0 0 0 0 0 4 2 12 2 12 18 11 20 20 2 1 2 21 13 2 1 21 12 16 