0 0 0 15 32 32 20 18 1 27 10 12 1 20 27 12 18 20 20 20 12 31 31 31 31 27 1 1 10 12 18 27 10 20 18 27 18 31 8 0 
0 0 0 0 0 0 22 27 12 27 1 12 20 26 21 21 2 13 21 27 12 12 20 20 27 20 12 20 1 27 20 12 1 20 20 27 20 27 25 0 
0 0 0 0 0 0 28 20 12 1 12 27 16 0 0 0 0 0 0 22 27 25 2 13 13 2 2 2 2 2 1 27 31 1 1 20 20 20 25 0 
0 10 10 18 10 31 12 27 27 27 1 12 8 0 0 0 0 0 0 28 25 0 0 0 0 0 0 0 0 0 22 12 1 20 27 12 1 20 1 31 
5 27 1 1 20 20 20 12 20 20 27 12 25 0 0 0 0 0 0 28 25 0 0 0 0 0 0 0 9 0 22 12 20 27 20 12 20 27 1 25 
12 1 27 1 12 12 1 12 12 27 12 20 8 0 0 0 0 0 14 20 2 30 0 0 0 0 0 0 0 0 22 20 20 20 12 20 1 27 1 16 
28 20 12 1 1 1 12 12 27 27 20 27 21 32 32 31 10 31 20 26 0 0 0 0 0 0 0 0 0 0 28 1 1 20 1 20 12 2 21 13 
12 27 1 27 27 12 1 1 12 20 12 25 0 0 0 4 27 1 25 0 0 0 0 0 0 0 0 0 0 0 28 12 1 12 20 1 16 0 0 0 
21 27 28 27 27 27 20 20 12 20 12 17 0 0 0 5 27 12 8 0 0 0 0 14 18 10 31 18 18 10 27 12 20 27 1 20 8 0 0 0 
0 4 27 20 1 1 1 20 27 1 27 8 0 0 0 28 27 12 20 18 10 1 0 6 13 12 20 20 13 13 21 13 2 2 1 12 27 18 29 0 
0 22 27 20 8 1 20 27 27 27 27 26 0 0 28 1 13 2 13 21 27 25 0 0 0 5 27 3 0 0 0 0 0 0 22 12 1 27 8 0 
0 4 20 12 27 1 12 27 27 12 16 0 0 0 4 25 0 0 0 0 22 8 0 0 0 28 27 16 0 0 0 24 0 0 28 20 12 12 1 29 
0 4 27 20 27 12 1 20 1 27 17 0 0 0 5 17 0 0 0 0 22 27 10 10 31 20 12 25 0 15 10 27 30 0 22 12 12 1 12 16 
0 22 27 1 20 1 20 20 20 2 2 24 0 0 6 1 29 0 0 0 28 12 31 1 20 12 1 8 0 0 5 17 0 0 22 12 12 20 20 25 
0 6 21 1 27 20 13 1 17 0 0 0 0 0 0 6 13 30 0 0 5 27 20 20 12 27 1 25 0 0 22 16 0 0 28 20 27 1 27 4 
0 0 0 4 27 20 1 1 17 0 0 0 0 0 0 0 0 0 0 14 12 27 12 20 12 27 22 20 31 18 20 25 0 0 22 27 12 1 12 21 
0 0 0 28 12 27 27 27 25 0 0 0 0 0 0 0 0 0 0 5 27 1 1 1 12 12 13 13 27 27 20 8 0 0 4 1 1 27 25 0 
0 0 0 6 21 12 27 12 8 0 0 0 0 0 0 0 0 15 18 1 12 1 20 2 2 26 0 0 4 12 2 13 19 19 12 20 1 27 26 0 
0 0 0 0 0 6 12 1 26 0 0 24 0 0 0 0 0 0 4 27 20 1 16 0 0 0 0 0 28 26 0 0 0 0 4 12 27 16 0 0 
0 14 29 0 0 0 5 8 0 0 15 2 10 18 29 0 0 0 4 21 20 13 13 0 0 0 0 0 7 0 0 0 0 0 4 20 20 16 0 0 
10 1 14 16 0 0 28 17 0 0 0 0 4 12 17 0 0 14 0 0 7 0 0 0 0 0 0 0 7 0 0 0 0 0 22 12 1 20 31 16 
4 1 13 2 19 32 13 2 30 0 0 0 5 27 17 0 0 23 0 0 7 0 0 0 0 0 0 0 4 29 0 0 0 0 22 1 20 12 27 1 
2 26 0 0 0 0 0 0 0 14 18 10 27 25 25 0 0 7 0 0 4 31 18 29 0 0 0 0 22 8 3 0 0 0 5 27 1 27 1 25 
0 0 0 0 0 24 0 0 0 28 20 1 1 12 27 18 31 17 0 0 18 20 20 8 0 0 0 0 4 20 12 31 10 31 20 27 1 12 20 25 
0 0 0 0 14 1 10 18 31 20 18 27 12 12 20 27 1 17 0 0 28 12 20 27 10 29 0 0 5 1 1 12 27 12 1 1 16 26 22 1 
9 0 0 15 21 20 12 20 27 2 13 2 2 12 20 12 20 1 31 18 1 27 20 20 20 27 18 18 1 20 27 27 1 1 20 27 20 10 20 8 
0 0 0 0 0 28 1 20 16 0 0 0 0 5 20 20 20 27 20 1 12 27 20 12 27 20 1 1 1 1 12 20 21 2 27 20 21 2 13 26 
0 0 0 0 0 4 27 20 16 0 0 0 0 22 27 21 13 13 27 27 27 1 12 12 1 13 2 1 1 20 20 26 0 0 22 25 0 0 0 0 
15 10 10 18 31 27 1 20 16 0 0 0 15 12 16 0 0 0 6 12 20 20 20 3 8 0 0 5 1 20 8 0 0 0 6 26 0 0 0 0 
0 22 20 2 2 21 12 27 16 0 0 0 0 5 8 0 0 0 0 6 12 27 1 12 16 0 0 5 27 27 16 0 24 0 0 0 0 0 0 0 
0 22 25 0 0 0 5 20 27 31 3 0 0 28 8 0 0 0 0 0 22 20 12 27 27 31 31 3 20 12 25 0 28 18 18 10 19 32 19 32 
31 10 8 0 0 0 28 20 27 1 12 10 11 2 21 11 29 0 0 0 5 1 21 21 20 12 2 2 2 2 26 0 4 27 20 25 0 0 0 0 
28 27 20 31 19 19 20 27 20 23 20 17 0 0 0 0 22 18 31 31 20 17 0 0 5 8 0 0 0 0 0 0 5 12 12 8 0 0 0 0 
5 1 1 8 0 0 4 27 1 12 12 8 0 0 0 0 28 21 13 13 12 8 0 0 5 25 0 0 0 0 0 0 28 20 20 26 0 0 0 0 
5 1 1 16 0 0 5 27 20 1 1 25 0 0 15 31 16 0 0 0 6 1 18 10 12 16 0 0 9 0 15 11 27 20 25 0 0 0 14 29 
27 1 27 12 18 10 20 12 1 2 2 8 0 0 0 5 25 0 0 0 0 5 27 12 1 16 0 0 0 0 0 0 28 12 16 0 0 0 28 22 
12 27 20 27 27 12 27 20 26 0 0 7 0 0 0 28 16 0 0 0 0 5 1 20 1 27 29 0 0 0 0 0 28 27 25 0 0 0 4 27 
12 27 20 27 12 27 27 16 0 0 0 22 10 31 31 27 12 31 18 31 31 12 27 27 20 1 20 32 30 0 0 0 22 20 12 10 10 18 27 1 
1 12 12 27 12 27 1 25 0 0 0 4 12 1 27 20 20 20 12 20 27 1 27 1 12 1 17 0 0 0 14 10 1 1 27 1 1 12 20 17 
6 1 12 27 1 1 21 26 0 0 0 28 12 1 13 1 1 12 12 2 20 13 2 13 12 2 8 0 0 0 6 2 27 13 20 17 12 13 2 21 