19 27 27 12 20 12 18 18 18 27 27 27 8 0 0 0 0 0 0 0 0 0 0 0 0 
0 5 27 27 20 12 20 12 20 1 12 27 25 0 0 0 0 0 0 0 0 0 0 0 0 
0 4 20 1 27 27 20 12 1 20 1 27 25 0 0 0 0 0 0 0 0 0 0 0 0 
18 1 20 17 20 20 1 20 20 20 20 1 17 0 0 0 0 0 0 0 0 0 0 0 15 
12 12 1 1 20 27 20 1 20 20 27 1 8 0 0 0 0 0 0 0 0 0 0 0 0 
28 1 27 27 27 27 12 27 27 20 20 27 8 0 0 0 0 0 0 0 0 0 0 0 0 
28 12 27 12 1 2 21 12 1 20 12 27 16 0 0 0 0 0 0 0 0 0 0 0 0 
12 13 12 27 8 0 0 5 20 12 20 20 25 0 0 0 0 0 0 0 0 0 0 0 0 
0 0 6 21 17 0 0 4 12 12 27 20 17 0 0 0 0 0 0 0 0 0 0 0 0 
0 0 0 0 6 11 32 27 1 20 12 20 20 31 29 0 0 0 0 0 0 0 0 0 0 
0 14 29 0 0 0 0 28 2 21 2 20 1 27 8 0 0 0 0 0 0 0 0 0 0 
14 12 16 0 0 0 0 23 0 0 0 5 12 20 20 29 0 0 0 0 0 0 0 0 0 
5 1 17 0 0 0 14 17 0 0 0 4 27 27 1 25 0 0 0 0 0 0 0 0 0 
28 20 8 0 0 0 28 25 0 0 0 28 1 12 1 20 29 0 0 0 0 0 0 0 0 
21 1 25 0 0 0 28 16 0 15 19 13 21 21 2 21 20 10 18 10 18 29 0 0 0 
0 22 17 0 0 14 12 8 0 0 0 0 0 0 0 0 6 27 27 27 12 25 0 0 0 
0 28 20 18 18 12 20 17 0 0 0 0 0 0 0 0 0 6 2 21 20 1 29 0 0 
31 12 12 12 12 20 27 25 0 0 0 0 0 0 0 0 0 0 0 0 4 20 20 31 31 
27 1 27 27 20 1 1 1 29 0 0 0 0 0 0 0 0 0 0 0 22 27 12 27 20 
12 20 20 12 20 1 20 27 25 0 0 0 0 0 0 0 0 0 0 0 28 12 20 27 25 
27 27 20 27 1 20 1 12 8 0 0 0 0 0 0 0 15 32 19 11 21 21 13 1 20 
20 12 27 13 21 21 13 13 13 32 11 11 29 0 0 0 0 0 0 0 0 0 0 22 20 
20 27 8 0 0 0 0 0 0 0 0 0 28 31 30 0 0 0 0 0 0 0 0 4 1 
27 20 17 0 0 0 0 0 0 0 0 0 5 8 0 0 0 0 0 0 0 0 14 12 12 
1 27 13 30 0 0 0 9 0 0 0 0 4 17 0 0 0 0 0 0 0 0 28 27 2 