0 0 28 20 27 31 18 31 1 31 10 31 1 27 25 0 0 0 6 12 1 10 20 13 2 
0 0 5 12 12 12 20 27 27 20 20 27 20 20 8 0 0 0 0 5 20 1 16 0 0 
0 0 22 12 1 20 20 12 12 27 1 20 27 1 12 10 29 0 0 28 27 12 17 0 0 
0 0 5 27 27 20 20 1 1 1 20 1 1 27 20 12 27 31 31 12 1 12 20 18 29 
0 0 5 20 1 20 12 12 27 1 20 12 1 20 12 12 20 12 12 12 27 27 27 12 16 
0 0 6 2 12 12 12 12 27 20 20 1 13 21 13 20 1 12 1 13 13 1 1 12 25 
0 0 0 0 4 27 12 27 1 20 27 8 0 0 0 22 13 13 8 0 0 4 20 1 27 
29 0 0 0 28 12 20 12 1 27 20 17 0 0 0 7 0 0 23 0 0 5 20 1 27 
16 0 0 0 5 13 13 20 20 20 20 1 10 18 31 16 0 0 7 0 0 5 20 27 12 
28 18 10 31 16 0 0 28 27 27 27 20 27 12 12 1 18 18 12 10 18 20 27 27 27 
4 27 20 27 17 0 0 4 12 1 20 12 2 2 12 27 20 1 1 20 12 1 27 20 8 
1 20 27 20 20 18 18 27 12 27 20 25 0 0 4 27 12 20 1 20 20 13 2 20 12 
27 1 20 20 12 27 27 27 20 27 20 16 0 0 28 1 20 12 20 27 16 0 0 4 1 
28 20 20 1 1 27 27 27 1 12 12 1 18 31 27 20 12 1 1 1 25 0 0 28 1 
20 1 1 27 20 20 1 12 12 27 1 1 12 1 20 27 27 12 20 12 1 10 31 1 16 
22 20 1 27 20 12 1 1 27 12 1 27 12 27 27 27 12 20 27 12 20 20 20 27 1 
22 1 20 12 20 1 1 20 1 1 27 20 27 12 1 1 12 12 27 1 12 27 1 27 17 
6 13 20 27 20 1 12 20 27 1 27 1 27 20 12 1 20 20 27 27 20 1 1 1 25 
0 0 6 27 27 27 27 20 27 1 12 20 20 27 20 20 12 27 27 12 20 27 1 1 17 
0 0 0 28 12 20 20 1 20 12 1 27 27 1 27 12 1 20 27 1 12 12 12 20 8 
0 0 0 4 1 12 20 20 1 20 1 12 20 12 20 20 20 1 1 27 20 12 12 1 16 
0 0 0 5 12 27 20 20 27 1 12 12 20 27 27 27 27 20 12 27 22 1 20 1 25 
0 0 0 4 12 1 20 1 20 12 12 1 20 27 1 27 20 20 12 1 27 12 12 27 8 
0 0 0 28 20 1 1 27 20 1 27 1 27 1 12 20 1 20 1 1 1 27 27 20 16 
0 0 15 2 1 20 20 2 27 1 21 21 1 21 12 21 27 1 2 13 20 21 2 1 8 