28 31 27 18 10 29 0 0 6 30 0 0 0 0 0 0 0 0 0 0 0 14 31 18 31 
28 12 20 27 20 25 0 0 0 0 0 9 0 0 0 0 0 0 0 0 0 28 27 1 27 
6 13 1 1 1 25 0 0 0 0 0 0 0 24 0 0 24 0 0 0 0 5 1 20 8 
0 0 28 12 20 25 0 0 0 0 0 0 0 22 31 18 17 0 0 0 0 28 1 27 25 
0 0 28 27 20 25 0 0 0 0 0 0 0 4 12 1 25 0 0 0 0 22 20 27 17 
0 0 22 1 12 12 29 0 0 0 0 0 0 4 27 27 12 29 0 0 0 5 12 1 25 
0 0 4 1 12 20 20 30 0 0 0 0 0 5 27 27 27 1 19 11 10 20 20 27 25 
0 0 5 27 12 20 17 0 0 0 0 0 0 5 27 12 1 17 0 0 5 20 20 12 25 
14 10 27 20 1 1 25 0 0 0 0 0 15 27 20 12 13 26 0 0 22 1 12 20 25 
22 12 1 1 20 27 25 0 0 0 0 0 0 4 12 8 0 0 0 0 5 12 1 12 16 
27 1 1 20 20 1 26 0 0 0 0 0 0 6 20 17 0 0 0 0 28 20 20 27 27 
1 1 27 12 20 25 0 0 0 0 0 0 0 0 5 12 29 0 0 0 5 20 27 12 1 
21 2 27 27 12 25 0 0 0 0 9 0 0 0 5 12 17 0 0 0 6 2 21 21 16 
0 0 4 12 12 17 0 0 0 0 0 9 0 0 4 27 12 29 0 0 0 0 0 0 7 
0 0 22 20 20 8 0 0 0 0 0 0 0 0 28 27 12 20 29 0 0 0 0 0 6 
0 0 6 13 2 25 0 0 0 0 0 0 0 0 28 1 27 20 17 0 0 0 0 0 0 
0 0 0 0 0 28 32 11 11 30 0 0 0 0 22 20 20 1 12 29 0 0 0 0 0 
0 0 0 0 0 23 0 0 0 0 0 0 0 0 6 12 20 12 1 8 0 0 0 0 0 
0 0 0 0 0 23 0 0 0 0 0 0 0 0 0 28 20 12 20 16 0 0 0 0 0 
0 0 0 0 0 23 0 0 0 0 0 0 0 0 0 28 20 27 1 12 31 31 18 18 29 
0 0 0 15 10 8 0 0 0 0 0 0 0 14 31 27 20 20 12 1 27 27 27 27 17 
0 0 0 0 22 8 0 0 0 0 0 0 0 5 20 12 20 20 27 20 1 20 2 21 13 
0 0 0 0 5 8 0 0 0 0 0 0 0 4 27 12 27 12 20 1 20 8 0 0 0 
0 0 0 14 27 25 0 0 0 0 14 31 18 12 12 1 12 1 1 1 12 8 0 0 0 
0 0 0 5 2 17 0 0 0 0 6 12 1 20 27 21 1 27 2 12 27 8 0 0 0 