20 10 18 1 31 18 12 1 10 12 18 31 12 10 31 10 10 1 27 10 2 2 11 13 32 21 32 19 31 27 20 31 18 12 12 31 18 16 0 0 0 0 0 0 0 0 0 0 0 0 
22 1 20 12 1 27 27 20 27 12 20 12 1 1 27 20 20 27 27 16 0 0 0 0 0 0 0 0 22 20 21 21 20 20 1 12 1 8 0 0 0 0 0 0 0 0 0 0 0 0 
6 13 13 27 27 20 27 1 20 27 12 12 1 20 20 12 27 12 1 8 0 0 0 0 0 0 0 0 4 26 0 0 28 12 1 12 27 8 0 0 24 0 0 0 0 0 0 0 0 0 
0 0 0 28 1 1 1 12 20 12 12 1 20 27 12 1 12 12 20 17 0 0 0 0 0 24 0 0 7 0 0 0 22 12 20 12 1 17 0 0 4 29 0 0 0 0 0 0 0 0 
0 0 0 28 1 12 1 20 12 20 1 12 27 27 12 12 1 1 1 1 11 11 29 0 0 5 18 31 16 0 0 0 6 13 1 27 27 27 10 31 27 25 0 0 0 0 0 0 0 0 
0 0 0 21 27 27 12 20 20 12 20 1 20 20 27 1 27 12 20 25 0 0 6 32 19 13 27 1 16 0 0 24 0 0 28 20 12 1 12 20 12 17 0 0 0 0 0 0 0 0 
0 0 0 28 20 20 20 12 12 12 1 1 20 1 1 12 13 2 20 17 0 0 0 0 0 0 22 20 20 18 10 25 0 0 6 1 1 20 12 1 27 16 0 0 0 0 0 0 0 0 
0 0 0 4 1 20 20 1 1 1 12 12 21 2 13 26 0 0 5 17 0 0 0 0 0 0 28 1 20 27 27 8 0 0 0 28 20 20 27 20 20 8 0 0 0 0 0 0 0 0 
0 0 0 5 27 12 12 1 20 27 1 25 0 0 0 0 0 0 6 26 0 0 0 0 0 0 5 20 12 1 20 12 29 0 0 28 12 20 27 1 1 17 0 0 0 0 0 0 0 0 
0 0 0 4 1 20 1 12 27 20 27 16 0 0 0 0 0 0 0 0 0 0 0 0 14 10 12 1 27 1 1 20 12 31 19 2 20 12 1 20 12 25 0 0 0 0 0 0 0 0 
0 0 0 6 1 27 20 27 27 1 21 26 0 0 0 0 0 0 0 0 0 0 0 14 12 27 20 20 12 1 27 1 1 25 0 0 6 1 12 20 20 16 0 0 0 0 0 0 0 0 
0 0 0 0 6 21 21 21 1 16 0 0 0 0 0 0 0 0 0 0 0 0 0 28 1 1 27 1 1 20 12 27 1 8 0 0 0 5 20 27 27 17 0 0 0 0 0 0 0 0 
0 0 0 0 0 0 0 0 6 26 0 0 0 0 0 0 0 0 0 0 0 0 15 12 27 1 20 27 27 12 27 27 27 27 29 0 0 28 27 12 1 8 0 0 0 0 0 0 0 0 
0 0 0 0 0 0 0 0 0 0 0 0 0 0 0 0 0 0 0 0 0 0 0 5 20 12 1 12 12 1 20 20 27 20 27 18 31 27 20 12 20 16 0 0 0 0 0 0 0 0 
0 0 0 0 0 0 0 0 0 0 0 0 0 0 0 0 0 0 0 0 0 0 0 22 27 12 12 20 21 21 13 12 27 1 12 20 1 20 12 1 20 1 29 0 0 0 0 0 0 0 
0 0 0 0 0 0 0 0 0 0 0 0 0 0 0 0 0 0 0 0 0 0 15 2 27 27 27 16 0 0 0 5 12 1 1 1 20 1 20 20 12 12 27 10 10 29 0 0 0 0 
0 0 0 0 0 0 0 0 0 0 0 0 0 0 0 0 0 0 0 0 0 0 0 0 28 1 27 16 0 0 0 4 12 20 27 1 1 1 20 20 1 1 1 27 27 25 0 0 0 0 
0 0 0 0 0 0 0 0 0 0 0 0 0 0 0 24 0 0 0 0 14 29 0 0 5 27 1 25 0 0 14 20 20 27 20 1 20 2 2 2 21 27 12 27 12 17 0 0 0 0 
0 0 0 0 0 0 0 0 0 0 0 0 0 0 0 22 31 18 31 18 27 1 10 32 13 2 13 1 29 0 6 1 1 27 27 20 17 0 0 0 0 5 1 12 1 16 0 0 0 0 
0 0 0 0 0 0 0 0 0 0 0 0 0 0 0 22 27 12 1 20 20 20 8 0 0 0 0 4 16 0 0 22 1 20 27 20 8 0 0 0 0 4 12 1 20 16 0 0 0 0 
0 0 0 0 0 0 0 0 0 0 0 0 0 0 0 4 20 20 27 1 12 27 8 0 0 0 0 22 26 0 0 4 27 12 12 1 8 0 15 19 19 12 1 20 27 12 29 0 0 0 
24 0 0 0 0 0 0 0 0 0 0 0 0 0 0 5 20 2 21 1 27 1 25 0 0 0 0 7 0 0 0 22 12 12 27 27 8 0 0 0 0 22 12 1 1 20 25 0 0 0 
25 0 0 0 0 0 0 0 0 0 0 0 0 0 0 4 25 0 0 28 12 27 2 30 0 0 0 23 0 0 0 22 20 27 20 20 16 0 0 0 0 4 12 1 20 1 25 0 0 0 
22 29 0 0 0 0 0 0 0 0 0 0 0 0 0 28 8 0 0 22 20 17 0 0 0 0 0 23 0 0 0 22 20 1 1 20 20 31 10 31 18 27 20 12 21 21 2 11 11 32 
12 20 30 0 0 0 0 0 24 0 0 0 0 0 0 22 12 32 32 20 27 8 0 0 0 0 0 5 10 10 31 12 27 1 20 20 20 20 20 27 27 1 20 16 0 0 0 0 0 0 
21 16 0 0 0 0 0 0 7 0 0 0 0 0 0 4 8 0 0 5 1 25 0 0 0 0 0 28 27 20 20 12 27 20 27 27 20 1 20 21 13 20 20 16 0 0 0 0 0 0 
0 7 0 0 0 0 0 0 4 29 0 0 0 0 0 22 8 0 0 5 27 8 0 0 0 0 0 5 12 12 20 1 2 13 1 12 20 1 16 0 0 22 12 17 0 0 0 0 0 0 
0 6 32 19 32 32 11 11 13 26 0 0 0 0 0 4 1 31 31 27 27 8 0 0 0 0 0 6 12 12 1 8 0 0 28 13 2 2 8 0 0 28 20 25 0 0 0 0 0 0 
0 0 0 0 0 0 0 0 0 0 0 0 0 0 0 4 12 1 1 12 27 25 0 0 0 0 0 0 28 27 27 8 0 0 23 0 0 0 4 31 11 2 2 13 32 19 30 0 0 0 
0 0 0 0 0 0 0 0 0 0 0 0 0 0 0 6 2 12 20 1 12 13 11 19 11 30 0 0 4 12 1 13 11 31 8 0 0 0 5 25 0 0 0 0 0 0 0 0 0 0 
0 0 0 0 0 0 0 0 0 0 0 0 0 0 0 0 0 22 20 12 16 0 0 0 0 0 0 0 4 20 16 0 0 4 27 31 31 10 20 25 0 0 0 0 0 0 0 0 0 0 
0 0 0 0 0 0 0 0 0 0 0 0 0 0 0 0 0 4 12 20 17 0 0 0 0 0 0 0 22 1 8 0 0 5 27 1 27 20 12 17 0 0 0 0 0 0 0 0 0 0 
0 0 0 0 0 0 0 0 0 0 0 0 0 0 0 0 0 4 1 20 17 0 0 0 0 0 0 0 5 1 1 18 18 12 27 20 12 20 1 17 0 0 0 0 0 0 0 0 0 15 
0 0 0 0 0 0 0 0 0 0 14 29 0 0 0 0 0 22 27 1 16 0 0 0 0 0 0 0 4 12 1 27 12 1 12 1 20 12 27 27 29 0 0 0 0 0 0 0 0 0 
0 0 0 0 0 0 0 0 0 0 22 20 10 18 29 0 15 12 1 12 20 30 0 0 0 0 0 0 4 27 20 1 1 27 20 12 1 12 20 27 16 0 0 0 24 0 0 0 0 0 
0 0 0 24 0 0 0 0 0 0 5 1 1 27 25 0 0 28 1 1 17 0 0 0 0 0 0 0 5 1 12 12 20 1 20 1 27 12 1 12 25 0 0 0 5 31 31 10 18 10 
0 0 0 4 18 29 0 0 0 0 4 12 20 27 17 0 0 5 12 27 17 0 0 0 0 0 0 0 4 1 27 27 20 1 20 12 12 20 20 27 20 18 31 10 1 1 12 1 12 16 
0 0 0 4 1 20 32 11 19 32 13 20 20 1 25 0 0 22 20 20 12 18 32 32 31 31 18 31 21 2 12 27 12 20 12 1 27 12 1 27 20 13 13 21 13 21 13 12 27 25 
0 0 0 22 2 26 0 0 0 0 0 6 20 12 12 31 31 1 1 27 1 25 0 0 28 1 12 17 0 0 22 1 20 1 12 1 1 12 12 27 25 0 0 0 0 0 0 4 12 16 
0 14 31 17 0 0 0 0 0 0 0 0 4 12 20 12 12 27 27 20 1 16 0 0 22 1 12 8 0 0 5 27 1 27 1 27 20 20 20 1 26 0 0 0 0 0 0 4 1 2 
0 4 12 26 0 0 0 0 0 0 0 0 5 12 20 20 27 27 20 1 12 27 18 31 20 27 27 12 18 18 27 1 12 27 1 12 27 12 1 25 0 0 0 0 0 14 10 13 26 0 
0 5 25 0 0 0 0 0 0 0 0 0 5 27 1 12 1 20 27 12 1 27 12 12 27 1 2 13 2 20 27 1 27 1 27 27 27 27 1 25 0 0 0 14 10 1 26 0 0 0 
32 12 25 0 0 0 0 0 0 0 0 0 28 1 27 20 12 12 27 12 12 27 1 1 27 16 0 0 0 22 1 27 20 27 27 20 1 27 27 16 0 0 0 22 12 16 0 0 0 0 
0 5 1 11 32 11 11 11 19 30 0 0 6 20 12 20 1 12 1 12 27 1 1 27 27 17 0 0 0 22 27 27 12 20 27 1 20 20 27 27 29 0 0 4 27 8 0 0 0 0 
0 22 17 0 0 0 0 0 0 0 0 0 0 28 12 1 27 20 12 1 1 20 20 20 20 20 18 10 18 27 1 27 27 12 20 27 20 1 20 27 12 18 18 27 20 17 0 0 0 0 
32 13 17 0 0 0 0 0 0 0 0 0 0 6 12 20 20 20 2 13 12 27 27 1 27 27 27 12 27 1 20 1 20 12 12 12 1 27 27 12 27 27 27 27 20 25 0 0 0 0 
0 0 23 0 0 0 0 0 0 0 0 0 0 0 6 20 20 16 0 0 5 1 20 20 1 27 27 27 20 20 27 12 12 27 20 27 12 27 12 1 27 1 20 20 12 12 30 0 0 0 
0 0 7 0 0 0 0 0 0 0 0 0 0 0 0 5 20 26 0 0 28 1 1 27 21 21 20 20 20 20 20 1 12 27 27 20 1 27 27 20 20 20 20 20 20 26 0 0 0 0 
0 0 23 0 0 0 0 0 0 0 0 0 0 0 0 22 25 0 0 0 28 1 12 16 0 0 28 1 27 20 12 12 20 27 12 1 12 20 27 12 12 12 1 12 16 0 0 0 0 0 
0 0 23 0 0 0 0 0 0 0 0 0 0 0 0 4 16 0 0 0 4 12 20 17 0 0 28 2 27 12 20 20 27 12 13 12 27 1 12 27 12 12 13 2 17 0 0 0 0 0 