0 0 0 0 0 0 0 4 38 30 0 30 23 45 0 0 0 0 0 0 
0 0 0 7 0 0 0 0 0 45 0 42 10 0 0 0 0 0 0 0 
0 0 0 0 0 0 0 0 0 0 0 0 15 37 0 0 0 44 0 6 
30 0 0 0 0 0 0 0 0 0 34 0 33 0 0 0 5 0 0 47 
10 0 41 0 0 0 0 0 0 0 0 0 0 0 0 0 0 37 6 0 
26 0 0 0 0 0 0 0 0 0 0 0 0 0 0 0 32 0 0 6 
17 0 4 16 0 38 0 0 0 0 0 0 0 0 0 0 0 0 0 0 
0 0 44 0 38 0 0 0 0 0 0 0 0 0 0 0 0 0 0 0 
0 5 37 0 0 0 0 0 0 0 0 0 0 0 0 54 51 32 0 0 
0 0 0 0 0 0 0 0 0 0 0 0 0 0 0 0 0 0 0 0 
39 0 0 0 0 0 0 0 0 0 0 0 0 0 0 0 0 0 0 0 
2 0 0 0 0 0 0 0 0 0 0 0 0 0 0 0 0 0 0 0 
0 0 0 0 0 0 0 0 0 38 3 0 0 0 0 0 0 0 0 0 
0 0 0 0 0 0 0 0 0 6 0 0 39 0 0 0 0 0 0 0 
0 0 0 0 0 0 0 0 0 0 0 0 0 0 0 0 0 0 0 0 
0 0 0 0 0 0 0 0 0 19 0 0 1 46 0 0 0 0 0 0 
0 0 0 0 0 0 0 0 0 0 42 38 38 0 0 39 0 6 0 0 
0 0 0 0 0 0 0 0 0 38 0 0 0 0 0 0 0 0 0 0 
0 0 0 46 0 5 0 0 0 0 0 0 0 0 6 0 38 0 0 0 
0 0 0 0 0 34 0 0 0 0 0 0 0 0 31 0 24 0 0 0 