0 0 3 54 54 0 0 16 32 0 0 0 42 17 0 0 0 0 1 0 0 0 0 0 0 
0 0 20 49 36 0 0 15 40 5 18 0 0 11 0 0 0 0 0 21 0 0 0 0 0 
0 38 2 0 31 36 0 46 0 41 0 0 0 0 0 0 0 0 0 0 0 0 0 0 0 
0 0 0 38 0 49 38 41 36 0 2 41 0 0 0 0 0 0 0 0 0 0 0 0 0 
0 0 0 0 4 0 46 1 0 0 33 2 37 0 0 0 0 0 0 0 0 0 0 0 0 
0 18 0 0 0 0 39 49 57 37 0 40 0 0 0 0 0 0 0 0 3 26 0 0 0 
2 0 0 0 0 33 0 0 34 3 0 20 37 0 0 0 0 0 0 0 0 0 0 0 0 
0 0 0 0 0 0 0 0 0 6 0 42 0 0 0 0 0 0 0 0 0 0 0 0 0 
0 0 0 6 0 3 0 54 6 0 0 3 30 0 40 0 0 0 0 0 0 0 0 0 0 
37 0 0 5 0 0 0 36 2 0 0 0 0 0 28 0 0 0 0 0 0 0 0 0 41 
0 0 0 3 0 0 0 0 0 0 0 0 0 0 0 0 0 0 0 0 0 0 0 0 0 
0 0 0 0 0 0 0 0 0 0 0 41 0 0 0 0 0 0 0 0 0 0 0 0 0 
0 0 0 0 0 0 0 0 0 0 4 0 0 0 5 37 0 0 0 0 0 32 0 0 0 
0 0 0 0 38 0 0 0 0 0 0 40 0 0 5 0 0 0 0 0 0 0 0 0 0 
0 0 0 0 0 0 0 0 0 0 40 0 0 0 0 0 0 0 0 0 0 15 0 0 0 
0 0 0 0 0 0 0 0 0 0 23 42 0 0 0 0 0 0 0 0 0 0 0 0 0 
0 0 0 0 4 0 0 0 0 0 0 0 0 0 0 0 0 0 0 0 0 0 0 0 0 
0 0 0 7 1 0 0 0 0 0 0 2 0 39 3 40 34 0 0 38 0 54 56 4 0 
0 0 0 54 0 0 0 0 0 0 0 4 41 1 0 0 0 0 0 0 0 5 0 0 0 
0 0 0 7 0 0 0 0 0 0 0 0 32 3 0 39 0 0 0 0 0 0 0 0 0 
0 0 0 0 0 0 0 0 0 0 0 0 0 42 0 37 0 0 0 0 0 0 0 0 0 
0 0 0 0 0 0 0 0 0 0 0 54 18 0 0 48 34 0 0 0 0 0 0 0 0 
4 6 0 0 0 0 0 0 0 0 0 31 0 35 0 0 38 35 0 0 0 0 0 0 0 
0 0 0 0 0 0 0 0 0 0 0 0 4 0 0 36 0 0 26 4 0 0 37 0 0 
0 0 0 0 0 0 0 0 0 0 0 0 47 0 21 37 35 2 0 0 0 0 0 0 0 