0 0 0 0 0 6 21 19 13 19 11 32 2 27 20 27 12 27 18 27 25 12 27 31 12 31 27 1 18 1 8 0 0 0 0 0 0 0 0 0 
0 0 0 0 0 0 0 0 0 0 0 0 0 6 12 27 27 21 21 13 13 13 13 20 27 21 2 1 20 20 8 0 0 0 0 0 0 9 0 0 
0 0 0 0 0 0 0 0 0 0 0 0 0 0 4 1 16 0 0 0 0 0 0 5 8 0 0 28 20 20 1 29 0 0 0 0 0 0 0 0 
0 0 0 0 0 0 0 0 0 0 0 0 0 0 22 20 17 0 0 0 0 0 0 22 16 0 0 5 20 12 1 25 0 0 0 0 0 0 0 0 
0 0 0 0 0 0 0 0 0 0 0 0 0 0 28 12 27 29 0 0 0 0 0 4 27 18 10 12 1 27 12 27 31 10 31 18 18 31 29 0 
0 0 0 0 0 0 0 0 0 0 0 0 0 0 4 1 1 8 0 0 0 0 14 13 21 12 12 1 12 27 20 2 21 20 27 27 27 12 27 10 
0 0 0 0 0 0 0 0 0 0 0 0 0 0 5 1 20 20 10 10 19 32 26 0 0 5 20 1 27 20 8 0 0 4 2 21 12 20 1 8 
0 0 0 0 0 0 0 0 0 0 0 0 0 0 4 1 1 20 27 17 0 0 0 0 0 28 12 12 1 20 16 0 0 7 0 0 28 27 21 2 
0 0 0 0 0 0 0 0 0 0 9 0 0 0 28 1 1 1 27 16 0 0 14 31 18 20 12 1 16 23 28 18 18 25 0 0 28 16 0 0 
0 0 0 24 0 0 0 0 0 0 0 0 0 0 28 27 20 12 12 20 19 32 12 27 1 12 27 27 20 31 2 12 27 27 18 10 21 17 0 0 
0 0 14 20 10 31 29 0 0 0 0 0 0 0 22 1 12 12 20 17 0 0 28 20 27 20 27 12 27 12 20 1 27 27 20 27 12 17 0 0 
0 14 27 1 27 1 16 0 0 0 0 0 0 0 6 21 12 27 1 16 0 0 5 1 20 27 20 1 1 20 27 1 12 27 27 27 12 20 19 32 
0 6 21 2 2 21 8 0 0 0 0 0 0 0 0 0 6 13 2 20 31 10 12 27 12 27 12 1 1 1 12 1 1 27 12 20 27 25 0 0 
0 0 0 0 0 0 6 18 29 0 0 0 0 0 0 0 0 0 0 6 13 20 20 12 12 12 2 13 27 1 12 1 1 12 27 12 12 8 0 0 
0 0 9 0 0 0 0 28 17 0 0 0 0 0 0 0 0 0 0 0 0 6 13 13 27 25 0 0 4 27 1 12 27 21 21 21 20 25 0 0 
0 0 0 0 0 0 0 17 21 32 30 0 0 0 0 0 0 0 0 0 0 0 0 0 28 17 0 0 4 12 20 12 16 0 0 0 22 17 0 0 
0 0 0 0 0 0 0 0 0 0 0 0 0 0 0 0 0 0 0 0 0 0 0 0 28 12 10 18 1 12 1 20 17 0 0 0 28 27 29 0 
0 0 0 0 0 0 0 0 0 0 0 0 0 0 0 0 0 0 0 0 15 31 31 18 27 12 27 12 20 27 20 20 20 31 31 18 27 20 1 10 
0 0 0 0 0 0 0 0 0 14 30 0 0 0 0 0 0 0 0 0 0 4 12 12 12 20 20 27 12 27 27 20 1 27 12 27 20 12 20 25 
27 0 0 14 31 31 10 31 18 8 0 0 0 0 0 0 0 0 24 0 0 5 27 1 20 1 20 1 21 13 27 20 20 1 1 22 12 20 20 8 
25 0 0 22 27 1 27 1 27 16 0 0 0 0 0 0 0 0 4 32 11 20 27 13 21 20 27 17 0 0 5 27 12 1 20 12 12 27 12 12 
13 0 14 27 4 12 27 20 27 20 31 29 0 0 14 18 10 18 8 0 0 5 16 0 0 28 1 17 0 0 28 1 1 1 12 20 12 21 12 25 
0 0 6 13 2 13 21 27 20 20 12 17 0 0 22 20 13 13 16 0 0 5 8 0 0 22 20 12 10 11 13 2 1 20 12 1 12 1 20 16 
0 0 0 0 0 0 0 6 21 21 21 25 0 0 28 16 0 0 28 18 10 27 1 10 31 1 1 12 8 0 0 0 22 12 1 20 1 12 20 17 
0 0 14 29 0 0 0 0 0 0 0 5 31 31 12 17 0 0 28 20 21 21 12 20 20 1 20 20 25 0 0 0 5 12 1 12 2 12 1 16 
0 0 22 27 31 29 0 0 0 0 0 4 1 20 1 17 31 10 12 17 0 0 5 20 1 12 20 1 25 0 0 0 28 20 12 12 1 12 12 12 
5 0 6 20 3 16 0 0 0 0 0 6 12 12 12 20 20 12 27 17 0 0 22 1 27 12 1 27 27 31 31 31 27 20 20 27 20 12 20 16 
0 0 0 4 12 25 0 24 0 0 0 0 5 1 12 20 27 1 1 17 0 0 4 12 12 5 21 13 2 2 2 21 20 27 12 1 27 12 12 25 
0 0 0 4 12 26 0 5 29 0 0 0 4 20 20 1 27 20 20 13 11 31 1 1 13 26 0 0 0 0 0 0 6 20 27 12 27 1 20 20 
27 0 0 4 25 0 0 5 8 0 0 0 22 1 20 1 27 12 25 0 0 6 13 16 0 0 0 15 30 0 0 0 0 28 1 1 27 12 27 1 
12 18 31 1 17 0 0 22 20 18 10 10 1 27 12 27 1 20 25 0 0 0 0 23 0 0 0 0 0 0 0 0 0 4 13 27 27 27 1 1 
4 20 12 12 27 31 10 2 13 21 2 20 20 12 1 20 1 27 25 0 0 0 0 5 10 10 18 10 18 18 10 31 11 13 20 13 2 1 27 17 
20 27 20 27 1 12 25 0 0 0 0 5 20 20 20 12 27 27 25 0 0 0 0 22 12 20 12 20 27 12 32 25 0 0 23 0 0 28 20 1 
12 1 20 1 21 20 25 0 0 0 0 5 20 27 27 27 27 20 27 18 23 10 10 12 20 1 12 12 2 13 27 25 0 0 23 0 0 5 12 16 
1 1 27 20 12 12 16 0 0 14 31 12 12 13 27 21 19 27 1 20 27 27 20 27 21 2 11 25 0 0 22 20 31 10 1 18 10 1 1 18 
27 12 12 14 13 12 25 0 0 22 20 1 27 18 7 0 0 4 27 27 27 21 13 25 0 0 22 8 0 0 4 20 12 2 21 10 12 27 27 1 
12 1 16 0 0 4 27 31 10 12 1 20 20 10 16 0 0 2 20 27 8 0 0 7 0 0 5 1 30 0 6 12 8 0 0 4 27 1 1 20 
4 20 25 0 0 4 27 27 12 18 13 13 21 12 25 0 0 4 20 1 25 0 0 6 32 31 1 8 0 0 0 28 8 0 0 6 12 27 1 25 
22 20 1 31 10 20 1 12 20 17 0 0 0 22 20 31 10 20 1 1 25 0 0 0 0 22 20 16 0 0 0 22 8 0 0 0 4 12 27 8 
6 12 13 20 13 27 1 20 12 16 0 0 0 28 1 1 1 21 20 2 25 0 0 0 0 4 13 26 0 0 0 4 21 30 0 0 6 12 13 2 