14 18 10 20 18 11 16 0 0 0 0 0 0 0 5 20 1 18 10 25 
4 20 12 1 1 12 25 0 0 0 0 0 0 0 4 21 13 13 13 17 
2 12 1 27 12 12 27 18 31 29 0 0 0 0 7 0 0 0 0 0 
0 6 21 21 20 27 6 1 27 8 0 0 0 14 17 0 0 0 0 0 
0 0 0 0 6 21 20 12 20 1 31 10 10 27 12 29 0 0 0 0 
0 0 0 0 0 0 5 27 27 27 1 20 20 1 20 16 0 0 0 0 
0 0 0 0 0 0 5 1 12 27 12 1 12 12 20 26 0 0 0 0 
0 0 0 0 0 0 22 12 20 12 20 27 27 1 16 0 0 0 0 0 
29 0 0 0 14 31 1 27 12 27 27 12 27 1 25 0 0 0 14 29 
6 32 10 31 27 20 1 12 12 27 20 12 20 20 20 10 31 10 1 16 
0 0 5 20 20 12 20 1 27 20 1 1 12 27 1 1 12 12 27 16 
0 0 28 12 27 20 12 20 20 2 2 13 2 21 1 20 12 28 12 25 
10 14 27 12 10 12 1 1 25 0 0 0 0 0 4 27 1 20 20 17 
14 12 27 12 12 20 1 20 16 0 0 0 0 0 4 3 20 20 12 20 
1 1 27 1 12 20 27 12 17 0 0 0 0 0 5 12 12 1 20 18 
20 27 1 20 27 27 12 20 17 0 0 0 0 0 28 2 2 21 1 1 
5 27 27 1 27 20 25 27 8 0 0 0 0 14 25 0 0 0 4 29 
12 1 27 21 21 2 12 1 25 0 0 14 10 12 26 0 0 0 4 25 
20 27 16 0 0 0 22 1 5 10 18 20 1 16 0 0 0 14 20 20 
6 20 16 0 0 0 22 27 2 27 2 2 12 8 0 0 0 4 21 21 