0 0 0 0 0 0 0 0 54 55 0 0 0 0 0 4 0 0 0 0 20 54 37 0 0 0 0 0 0 0 0 0 0 0 0 0 0 0 0 0 
0 0 0 0 0 0 0 0 6 0 0 53 32 0 0 0 0 17 0 36 0 3 42 0 32 0 0 0 0 0 0 0 0 0 0 0 0 0 0 0 
0 0 0 0 0 0 0 0 39 36 46 4 0 0 4 0 0 33 0 0 0 0 54 0 0 0 0 0 0 0 0 0 34 18 0 0 0 0 0 0 
0 0 0 0 0 0 0 0 5 0 0 0 0 36 0 0 2 0 0 0 0 0 0 0 0 0 0 0 0 0 0 0 0 17 1 0 0 0 0 0 
0 0 0 0 0 38 0 0 0 18 0 35 34 0 33 0 1 0 20 0 0 0 0 0 0 0 0 0 0 0 0 0 0 38 0 0 0 0 0 33 
0 0 0 0 0 0 37 41 0 34 55 0 54 0 0 0 8 33 0 0 0 34 0 0 0 0 0 0 0 0 0 0 55 5 0 0 0 0 43 10 
0 0 0 0 0 0 0 40 25 35 6 0 0 0 12 4 42 0 0 0 38 15 0 38 47 0 0 0 0 0 0 0 0 0 0 0 0 0 29 0 
0 0 0 0 0 0 0 6 28 38 0 54 0 5 0 0 0 0 0 0 0 0 52 0 41 0 0 0 0 0 0 0 0 0 0 0 0 0 0 0 
0 0 0 0 0 0 0 0 0 0 37 0 33 41 0 0 0 0 0 0 0 0 0 0 0 0 0 0 0 0 0 0 0 0 0 0 0 0 0 0 
1 0 0 0 0 0 0 0 0 0 0 35 0 0 0 0 34 0 0 0 4 4 0 0 0 0 0 0 4 0 0 0 0 0 0 0 0 0 1 0 
0 0 0 0 0 0 0 0 0 26 0 4 14 0 0 0 0 0 0 0 6 0 34 0 0 0 0 0 0 0 0 0 0 0 0 0 0 33 0 33 
52 0 0 0 1 0 0 0 0 50 0 53 30 0 42 0 0 0 0 0 29 0 41 6 32 51 22 0 0 0 0 4 0 0 0 0 0 11 11 15 
31 1 0 0 0 0 0 0 0 0 48 0 0 0 33 0 0 0 0 0 24 3 1 0 5 0 0 0 0 0 0 0 0 0 0 0 0 0 0 0 
0 0 0 0 0 0 0 0 0 0 0 0 0 0 0 0 0 0 0 0 0 0 0 39 0 0 5 0 0 0 0 2 0 0 0 0 28 0 0 1 
38 0 0 36 0 0 0 0 0 0 0 0 0 0 0 0 0 0 0 0 0 0 0 28 0 0 0 0 0 0 0 0 30 0 0 55 31 0 11 0 
0 0 0 46 0 0 0 0 0 0 0 36 0 0 0 0 0 0 0 0 0 0 0 0 0 0 0 0 0 37 0 25 3 0 0 33 0 0 0 0 
0 0 0 0 0 0 0 0 0 0 0 51 0 57 44 1 0 0 0 0 0 0 0 0 0 0 0 0 0 0 27 38 57 0 0 0 0 0 0 0 
48 0 0 0 0 0 0 0 0 39 54 3 0 28 0 0 0 0 0 0 0 0 0 0 0 0 0 0 0 0 34 0 0 0 0 0 0 0 0 0 
17 0 0 0 0 0 0 0 0 0 0 40 39 0 33 0 50 5 0 0 0 0 0 0 0 0 0 0 0 0 0 0 0 0 0 0 0 0 0 0 
0 0 0 0 0 0 0 0 25 0 0 0 1 13 0 0 0 0 0 0 0 0 0 0 0 0 0 0 0 0 0 0 0 0 0 0 0 0 0 0 
32 0 36 0 0 0 0 0 0 0 0 37 7 38 0 38 47 0 0 0 0 0 0 0 0 0 0 2 44 30 0 0 0 0 0 0 0 0 0 0 
25 7 31 0 0 0 0 0 0 0 34 0 0 0 0 0 40 34 0 0 0 0 0 0 0 0 0 6 0 33 0 0 0 0 0 0 0 0 3 0 
0 0 31 0 0 0 0 0 0 0 31 39 0 0 27 33 0 0 23 42 0 0 0 0 0 0 0 0 0 0 0 0 0 0 0 0 0 0 19 0 
0 5 0 0 0 0 0 0 0 3 31 0 0 37 0 21 32 0 31 31 3 0 0 0 0 0 0 0 0 0 0 0 0 0 0 0 0 0 0 31 
0 0 0 0 0 0 0 0 0 0 0 0 3 0 0 0 34 45 0 0 0 0 0 0 0 0 0 0 0 0 0 0 0 0 0 0 0 0 31 0 
0 0 0 0 0 34 0 0 0 0 0 0 0 0 0 2 0 29 0 0 0 0 0 0 0 0 0 0 0 3 0 0 0 0 0 0 0 0 0 0 
0 0 0 0 0 0 0 0 0 0 0 0 32 1 0 0 0 0 0 0 0 31 4 29 48 0 0 0 0 0 0 0 0 0 0 0 0 0 0 0 
36 0 0 0 0 0 0 0 0 0 0 0 0 0 0 2 3 0 0 0 0 0 0 0 19 0 0 0 0 0 0 0 0 0 0 0 0 0 38 33 
0 0 0 0 0 0 0 0 0 0 0 0 0 0 0 34 0 0 0 0 34 0 0 0 12 0 0 0 0 0 0 0 0 0 0 30 39 39 0 0 
0 0 0 0 0 0 0 0 0 0 0 0 0 0 31 32 0 0 0 0 0 0 0 0 0 0 0 0 0 0 0 0 0 0 0 0 27 0 0 0 
7 0 0 0 0 39 20 0 0 0 0 0 0 0 0 0 0 0 0 0 0 0 0 0 0 0 0 0 0 0 0 0 0 0 38 10 0 0 0 0 
0 0 0 0 0 0 0 0 0 0 0 0 0 0 0 0 0 0 0 0 0 0 0 0 0 0 0 0 0 0 0 0 0 0 0 0 0 0 0 35 
3 0 0 0 0 4 0 1 0 0 0 0 0 0 0 35 0 0 0 0 0 0 0 0 0 0 0 0 0 0 0 0 0 0 0 0 0 42 10 6 
0 0 0 0 42 45 30 3 54 32 0 0 0 1 23 0 0 0 0 0 0 0 0 0 0 0 0 0 0 0 0 0 0 0 6 0 42 0 0 0 
0 0 0 2 0 0 49 41 0 0 0 0 0 37 0 0 0 0 0 35 0 0 0 0 0 0 0 0 0 7 11 0 0 0 0 46 38 0 42 6 
0 0 0 0 5 0 0 0 36 28 32 0 0 0 0 0 0 0 0 0 0 0 0 0 0 0 0 0 0 9 54 0 0 0 2 0 47 33 36 0 
0 0 0 0 0 0 0 0 0 0 0 0 0 0 3 0 0 0 0 0 0 0 0 0 0 0 0 0 0 0 40 0 0 0 0 0 0 54 9 0 
0 0 0 0 0 0 0 0 0 0 0 0 0 0 38 0 0 0 0 0 0 0 0 0 0 0 0 0 0 0 0 0 0 0 0 0 0 0 0 0 
0 0 0 0 0 0 0 0 0 0 0 0 0 0 0 0 0 0 0 0 0 0 0 0 15 0 0 0 0 0 0 0 0 0 0 0 0 0 0 0 
0 0 0 0 0 0 0 0 0 0 0 0 0 0 0 0 0 0 0 0 0 0 0 0 17 39 0 0 0 0 0 0 0 0 0 0 0 0 0 0 