23 0 36 0 0 0 0 0 0 0 0 0 0 0 0 0 6 0 0 0 0 0 37 0 47 4 0 0 0 0 0 0 0 8 0 0 32 0 0 0 
0 12 37 34 0 0 0 0 0 0 0 0 0 0 3 6 0 22 0 0 0 22 0 0 42 0 54 0 0 0 0 10 0 39 43 0 0 0 2 34 
0 0 5 0 0 0 0 0 0 0 0 0 0 0 0 0 0 0 0 0 0 0 0 34 0 39 32 0 0 0 0 0 6 0 0 0 35 25 39 17 
0 0 0 0 0 0 0 0 0 0 53 28 34 8 0 54 26 0 0 0 0 0 0 0 0 35 0 0 0 0 0 0 0 0 0 0 35 42 0 0 
0 0 0 0 0 0 0 0 0 0 0 0 0 0 0 0 0 0 0 0 0 0 0 0 0 40 44 34 5 31 5 0 0 0 0 0 0 0 0 0 
0 0 0 0 0 0 0 0 16 16 0 0 0 42 40 39 31 0 0 0 0 0 0 0 0 54 0 0 0 1 0 0 0 0 0 0 0 0 0 0 
0 0 0 0 0 0 41 0 9 44 0 0 0 0 8 0 34 0 0 0 0 0 0 0 0 0 0 0 0 0 0 0 0 0 0 0 0 0 0 0 
0 0 0 0 0 0 0 31 0 0 0 0 0 0 0 0 0 0 0 0 0 0 0 0 0 0 0 22 0 0 0 0 0 0 0 5 17 0 31 0 
0 0 0 0 0 0 0 24 41 53 31 0 0 0 0 38 10 13 27 0 31 0 0 0 0 0 0 37 0 0 0 0 0 0 0 35 3 0 33 2 
0 5 33 0 0 0 0 0 0 0 0 0 0 0 0 0 1 0 42 0 40 5 0 0 0 0 0 0 0 0 0 0 0 0 0 0 4 0 0 0 
0 5 0 4 29 0 0 0 0 0 0 0 0 0 0 38 35 0 3 0 0 37 4 43 0 0 0 0 0 0 0 0 0 0 0 35 0 0 0 0 
0 38 17 34 0 0 0 0 0 0 0 0 0 0 16 0 0 0 0 0 45 0 6 0 34 31 6 0 0 0 0 0 0 0 0 0 16 0 0 0 
0 0 0 5 36 0 0 0 0 0 0 0 0 0 0 0 0 0 0 0 29 0 6 0 0 0 0 0 0 0 0 43 38 0 0 0 0 0 0 40 
19 0 0 31 26 0 0 0 0 0 0 0 0 0 0 0 0 0 0 0 53 0 31 3 0 0 0 0 0 0 0 0 0 0 0 0 0 0 0 0 
0 0 0 0 0 16 39 0 0 0 0 0 0 0 0 0 0 0 0 0 12 0 0 0 0 50 0 0 0 0 0 0 0 0 0 0 0 2 0 0 
0 0 0 0 32 0 29 0 0 0 0 0 0 0 0 0 0 0 0 0 0 56 0 0 0 11 0 0 0 0 0 0 0 0 0 0 0 0 33 0 
0 0 0 0 30 36 0 0 0 0 0 0 0 0 0 0 0 0 0 0 0 0 0 0 0 0 0 0 0 0 0 0 0 0 0 0 0 0 7 37 
0 0 0 0 0 0 34 0 0 0 37 0 39 0 0 0 0 0 0 0 0 0 0 36 38 0 0 0 0 0 0 0 0 0 0 0 0 33 2 0 
0 0 0 0 0 3 0 0 0 31 0 53 0 22 0 0 0 0 0 32 44 32 0 14 0 0 0 0 0 0 0 0 0 0 0 0 0 0 0 0 
0 0 3 0 0 0 0 0 0 0 48 37 4 0 0 0 0 0 0 15 0 57 0 2 0 0 0 0 0 0 0 0 0 0 9 0 0 0 0 0 
0 0 0 12 0 0 0 0 0 0 0 4 37 0 0 0 0 0 0 0 31 0 0 37 0 0 0 0 0 0 0 0 0 0 0 0 54 0 0 0 
0 0 0 0 0 0 0 0 0 0 0 0 0 0 0 0 0 0 0 0 0 0 0 0 0 0 0 0 39 25 0 0 0 0 0 0 0 0 0 0 
0 0 40 0 0 0 0 17 29 0 53 0 0 0 0 0 0 0 0 0 0 0 0 37 9 0 0 0 45 54 4 42 0 0 0 0 0 0 0 0 
0 0 57 35 0 0 0 0 0 0 9 7 0 0 0 0 0 0 0 0 0 0 0 0 37 0 13 0 0 0 0 0 0 0 0 0 0 41 0 0 
40 0 21 0 0 0 0 0 0 0 0 0 0 3 0 0 0 0 0 0 0 0 0 0 0 17 24 0 0 0 0 0 0 0 0 7 0 0 0 0 
0 0 0 0 0 0 0 0 0 0 0 0 0 0 0 0 0 0 0 0 0 0 0 0 0 0 6 0 0 0 0 0 0 0 0 54 42 0 0 36 
0 42 6 0 0 0 0 0 0 50 0 0 0 0 39 0 0 0 0 0 0 0 0 0 0 29 0 0 0 0 0 0 0 0 0 0 18 6 0 0 
0 0 0 0 0 0 0 0 40 0 5 0 0 20 39 0 0 33 0 0 0 0 0 0 0 0 0 0 45 0 0 0 0 0 0 0 0 0 0 54 
0 0 34 15 0 0 0 0 31 34 0 0 0 6 0 0 0 0 0 0 0 0 0 0 0 3 57 0 0 0 0 0 0 0 0 31 0 40 0 0 
0 0 16 0 0 0 0 0 0 0 0 0 0 0 0 0 0 0 0 0 0 0 0 0 0 34 0 0 0 0 0 0 0 0 0 31 52 22 0 0 
0 0 0 0 0 0 0 0 0 0 0 0 0 0 0 0 0 0 0 0 0 0 0 0 0 0 0 0 0 0 0 0 0 0 0 0 0 25 38 0 
0 0 0 0 0 0 0 0 0 34 0 0 0 0 0 0 0 0 0 0 0 0 0 0 0 0 0 15 0 0 0 0 41 0 0 0 36 0 0 0 
0 0 0 0 0 0 0 0 0 0 37 0 0 0 0 0 33 0 0 0 0 0 0 0 0 0 3 34 0 0 0 0 0 0 0 0 0 0 0 0 
0 0 0 0 0 0 0 0 0 0 0 0 0 0 0 0 10 0 0 0 0 0 0 0 0 0 0 0 0 0 0 39 34 0 0 5 38 0 0 0 
0 0 0 0 0 0 0 0 0 0 0 0 0 0 0 0 4 5 0 0 0 0 0 0 0 0 0 0 0 0 0 0 15 0 0 1 10 0 0 0 
0 0 0 0 0 0 0 0 32 17 15 0 0 0 0 0 0 0 0 0 0 0 0 0 0 0 11 10 0 0 0 0 0 0 0 0 0 0 0 0 
0 0 0 0 0 0 34 46 0 2 21 0 0 0 0 0 0 0 0 0 0 0 0 0 0 0 9 0 39 0 0 0 0 0 0 0 0 0 0 0 
0 33 23 0 0 0 0 0 0 0 0 0 0 0 0 0 0 0 0 34 0 0 0 0 22 0 0 41 0 3 0 0 0 0 0 0 0 0 0 0 
0 0 0 0 0 0 0 0 0 0 41 0 55 0 0 0 0 0 0 23 12 0 0 0 41 0 0 0 0 0 0 0 0 0 0 0 0 0 0 0 
0 0 0 0 0 29 0 36 0 0 36 0 38 0 0 0 0 0 0 0 55 0 0 0 0 0 0 0 0 0 0 0 0 0 0 0 0 0 0 0 