0 0 0 0 0 0 0 0 0 0 0 0 0 34 0 0 0 0 0 0 0 0 0 0 0 0 0 0 0 0 0 0 0 0 0 0 0 0 0 3 
47 0 0 0 0 0 0 0 0 0 0 0 39 0 25 0 0 0 0 0 0 0 0 0 0 0 0 0 0 0 0 0 0 0 0 0 0 0 0 1 
32 0 0 0 0 0 0 0 0 0 0 0 0 0 0 0 0 0 0 0 0 0 0 0 0 0 0 0 0 0 0 0 0 0 37 34 0 0 0 0 
0 55 0 0 0 0 0 0 0 0 0 0 0 0 7 3 0 0 0 0 0 0 0 0 0 0 34 0 41 0 33 0 0 46 0 0 38 0 0 0 
0 0 0 0 0 0 0 0 0 45 0 40 0 0 33 10 0 0 0 0 0 0 0 35 37 41 0 0 0 41 36 21 0 43 4 0 0 6 0 0 
0 0 0 0 0 0 0 0 6 39 6 36 0 0 0 0 0 0 0 0 0 0 0 0 0 34 0 41 0 34 0 0 0 0 53 0 42 4 0 0 
0 0 0 0 0 36 0 0 0 0 0 0 0 0 0 0 35 0 0 6 0 0 0 0 0 0 42 35 0 33 0 0 0 0 0 0 0 0 0 0 
0 0 0 0 0 36 0 0 0 0 0 0 0 0 0 0 0 0 0 0 0 0 0 32 0 0 10 1 8 10 6 0 0 0 0 0 0 0 0 0 
0 0 0 0 0 0 0 0 0 0 0 0 0 0 0 0 0 0 0 0 0 0 0 0 0 0 0 32 3 0 0 0 0 0 0 0 0 32 0 0 
0 0 0 0 0 0 0 0 0 0 0 0 0 19 0 0 0 0 0 0 0 0 0 0 0 0 13 31 0 43 0 0 0 0 0 0 0 6 8 31 
0 0 0 7 12 0 0 0 0 0 0 0 0 30 33 0 0 0 0 0 0 51 31 0 0 0 0 40 6 0 0 0 0 0 0 0 0 0 0 1 
0 0 0 32 0 0 0 0 0 0 0 0 0 0 0 27 1 42 0 0 0 0 0 0 0 0 0 0 0 33 0 6 0 40 0 0 8 0 0 42 
0 0 30 10 0 0 0 0 6 0 0 0 0 36 0 34 16 0 0 0 0 0 6 0 0 0 0 0 0 0 0 0 0 0 0 0 0 0 0 0 
9 0 0 29 0 0 0 0 36 0 0 0 0 3 0 3 39 5 12 41 0 0 0 0 0 1 27 48 0 4 0 0 6 0 0 0 1 26 4 0 
0 0 0 0 0 0 0 0 0 0 0 0 0 0 37 0 0 37 0 32 0 0 0 19 0 0 0 40 0 0 11 0 36 0 0 0 0 27 0 0 
7 36 0 0 0 0 0 0 0 0 0 0 0 0 40 0 0 0 0 0 0 0 0 0 24 0 0 55 0 5 0 42 0 0 0 0 0 0 0 18 
10 0 0 0 0 0 0 35 0 10 0 0 0 0 0 17 0 0 0 0 0 0 0 12 56 0 0 32 17 0 0 0 0 0 0 0 0 0 0 0 
0 31 0 0 0 0 0 0 0 26 0 0 0 0 0 0 0 0 0 0 0 0 2 0 0 0 0 21 0 0 0 0 0 0 0 0 0 0 0 0 
0 19 30 0 0 0 0 0 0 0 0 0 0 6 0 0 36 23 0 0 0 0 0 0 0 0 0 0 0 0 0 0 0 0 0 0 0 0 0 0 
0 22 41 4 0 0 0 0 33 14 0 0 0 0 0 0 0 0 0 0 0 0 0 0 0 0 0 0 0 0 0 0 0 0 0 0 0 0 0 0 
0 40 47 0 0 0 0 0 9 27 0 0 0 0 0 0 0 0 7 4 0 0 0 0 0 0 0 0 0 0 0 0 0 0 0 0 0 0 0 0 
0 0 0 0 0 0 0 0 0 0 0 0 0 0 0 0 0 42 0 0 0 0 0 0 0 0 0 0 0 0 42 0 0 0 0 0 0 0 0 0 
0 0 0 0 0 25 37 0 0 0 0 0 0 0 0 0 0 26 0 0 0 0 0 0 0 0 0 0 0 0 0 0 0 0 0 0 0 0 0 0 
0 2 0 0 0 0 0 0 0 0 1 0 20 0 0 0 0 0 0 0 0 0 0 0 0 0 0 0 0 0 0 0 0 0 0 0 0 0 0 0 
0 42 28 0 0 0 0 0 0 0 0 33 2 0 0 0 0 0 0 0 0 0 0 0 0 0 0 0 0 0 0 6 0 0 0 0 0 0 0 0 
0 0 0 0 0 0 0 0 0 0 0 39 0 42 0 0 0 0 0 0 0 0 0 0 0 0 0 0 0 0 0 40 0 0 0 0 0 0 0 0 
0 0 0 0 0 0 0 0 0 0 0 0 0 40 0 0 0 0 0 42 0 0 0 0 0 0 0 0 0 0 0 0 37 0 0 0 0 0 0 0 
0 0 0 0 0 0 0 0 0 0 0 0 0 0 0 0 0 0 0 33 0 0 0 0 0 0 0 0 0 0 0 0 0 0 0 0 0 0 0 0 
0 0 0 0 0 0 35 0 0 0 0 0 21 0 0 0 0 0 0 0 0 0 0 38 0 54 0 0 0 0 0 0 0 0 31 0 41 0 0 0 
0 0 0 0 55 0 5 0 0 0 0 0 0 0 0 0 0 0 0 5 0 54 0 0 6 0 0 0 0 0 0 0 0 0 0 0 0 0 0 0 
0 0 0 0 29 55 0 0 0 0 0 0 0 0 0 0 0 0 0 55 0 0 0 0 0 0 0 0 36 0 0 0 0 0 0 0 16 39 0 0 
0 0 0 0 0 0 0 0 0 0 0 0 0 0 0 0 0 0 0 0 0 0 0 31 40 25 0 0 37 30 0 0 0 0 0 0 34 12 0 0 
0 0 24 0 0 0 0 0 0 0 0 0 0 0 0 0 0 0 0 0 0 0 0 0 33 0 23 0 0 0 0 0 0 0 0 0 6 1 0 0 
0 0 34 0 0 0 0 0 0 0 0 0 0 0 0 0 0 0 0 0 0 0 0 0 19 0 0 0 0 0 37 41 0 0 0 0 0 0 0 0 
0 0 0 0 0 0 0 0 0 0 0 0 0 0 0 0 0 0 0 0 0 0 0 0 0 37 0 0 0 0 0 37 0 0 0 0 0 0 0 0 
0 0 0 0 0 0 0 0 0 0 0 2 0 0 0 0 0 0 0 0 0 0 0 6 0 0 0 0 0 0 0 0 0 0 0 0 0 0 0 0 
0 0 0 0 0 0 0 0 0 0 0 0 0 0 0 0 0 0 0 31 0 0 0 34 42 32 0 0 0 0 0 0 0 3 0 0 0 0 0 31 
1 0 0 0 0 0 0 0 0 0 0 0 0 0 20 2 0 0 4 0 0 0 0 0 0 53 0 0 0 0 0 0 17 0 0 0 0 0 0 38 
0 0 0 0 0 0 0 0 0 0 0 0 0 37 0 0 0 0 0 0 0 0 30 0 26 33 0 35 0 0 0 0 0 0 0 0 0 0 0 37 
15 0 0 0 0 0 0 0 0 0 0 0 0 42 31 0 0 0 0 0 0 41 0 21 0 0 0 55 0 0 0 0 0 0 0 0 0 0 0 0 