0 0 0 0 43 0 0 0 0 0 0 0 0 0 0 0 0 0 0 0 0 0 0 0 0 0 0 0 0 0 0 0 0 41 0 0 0 0 0 36 
0 35 24 37 10 35 0 17 0 6 1 19 0 0 0 0 0 0 0 0 0 0 0 0 0 0 0 0 0 0 0 19 0 0 32 3 1 0 0 0 
0 0 0 0 0 0 55 45 36 35 32 0 32 0 0 0 0 0 0 55 0 3 0 0 0 0 32 0 0 0 0 0 54 19 0 0 49 21 0 41 
42 0 0 25 0 32 0 0 30 0 0 32 0 9 0 0 0 0 0 5 0 48 12 0 0 0 0 0 0 0 0 0 25 40 4 33 0 37 0 0 
0 34 0 0 0 0 35 0 35 0 0 0 35 0 0 0 0 0 0 31 36 11 0 0 0 0 0 0 0 0 0 0 0 0 0 0 0 0 0 0 
47 0 0 20 41 0 0 0 3 0 44 0 40 0 0 0 0 0 42 3 0 40 0 0 0 0 0 0 0 0 0 0 0 0 0 0 0 0 0 0 
0 0 4 0 0 32 0 31 0 31 28 33 37 0 0 0 0 0 0 0 0 0 0 40 0 0 0 0 0 0 0 0 0 0 0 0 0 0 0 0 
4 30 0 0 0 0 31 0 0 0 36 0 0 32 0 0 0 0 0 0 0 0 15 11 0 0 0 0 0 0 0 33 0 0 0 35 0 0 0 0 
0 30 0 0 0 0 0 6 0 0 0 0 0 0 0 0 0 0 0 0 0 0 0 0 0 0 0 0 0 0 0 0 0 0 10 1 0 0 0 5 
0 0 2 0 0 41 0 37 0 46 45 1 0 0 0 0 0 0 0 0 0 0 0 0 0 0 0 0 0 0 0 0 0 0 0 0 0 0 0 0 
18 0 0 0 0 0 0 3 0 38 0 0 45 0 0 0 0 0 0 0 7 6 0 0 0 0 0 0 0 0 0 0 0 0 0 0 0 0 0 0 
0 0 0 0 0 0 0 0 1 38 42 0 0 34 0 0 0 0 0 0 1 0 0 0 0 0 0 0 0 0 0 0 0 0 0 0 0 0 0 0 
42 0 0 0 0 0 0 23 0 41 0 0 37 0 0 18 0 0 0 0 0 0 0 0 0 0 0 0 0 0 0 0 0 0 0 0 0 0 0 32 
21 0 0 35 38 55 0 0 0 0 0 0 0 0 0 0 41 0 0 0 0 0 0 0 0 0 0 0 0 0 0 0 0 0 0 0 0 0 0 0 
0 0 0 47 26 0 36 0 0 33 10 21 0 0 0 42 0 3 0 40 0 0 0 0 0 0 29 3 0 0 0 0 0 0 0 0 0 0 0 4 
1 0 39 36 0 37 4 0 0 0 0 32 30 0 0 0 0 0 0 0 26 38 0 0 0 0 0 0 0 0 0 0 0 0 0 37 0 0 0 0 
26 34 0 0 0 0 50 24 40 0 0 0 0 0 6 0 41 0 4 0 0 0 57 34 0 0 0 0 0 32 0 0 0 0 41 0 0 0 0 12 
0 0 21 41 0 42 0 5 34 0 54 37 0 0 36 35 0 0 2 3 0 0 0 0 0 0 0 0 0 0 0 0 0 0 0 0 0 0 0 0 
0 6 0 46 0 5 39 27 0 0 0 33 0 8 34 0 34 17 42 5 0 0 0 0 0 0 0 0 0 0 0 0 0 0 0 0 0 0 0 0 
0 0 42 0 0 0 0 0 0 0 0 0 0 0 0 0 35 47 0 21 4 0 0 0 0 0 0 0 0 0 0 0 0 0 0 0 0 0 0 0 
0 0 0 0 0 0 0 0 0 0 16 0 0 31 0 13 29 33 0 0 0 0 0 0 0 0 0 0 0 5 0 0 0 0 0 0 0 0 0 0 
0 0 0 0 0 0 0 0 0 0 0 0 0 0 0 0 0 0 0 0 41 0 0 4 0 0 0 0 45 6 0 0 0 0 0 0 0 0 0 0 
0 0 0 0 0 0 0 0 0 0 0 0 1 38 0 0 0 0 0 0 0 0 0 0 0 0 0 0 0 0 0 0 0 0 0 0 0 0 0 0 
0 0 3 54 0 20 36 0 0 0 0 0 0 0 0 0 13 34 0 0 0 0 0 0 0 0 0 0 0 31 0 37 0 0 0 0 0 0 0 0 
0 0 0 0 0 39 0 53 0 1 54 0 0 0 0 0 33 0 0 0 0 0 0 0 0 0 0 0 0 18 6 51 0 0 0 0 0 0 0 0 
41 30 0 0 0 0 31 0 0 0 19 0 0 0 0 0 0 0 0 0 0 0 0 0 0 0 0 0 0 0 25 0 0 0 0 0 0 0 0 0 
0 0 0 0 0 0 27 44 0 0 0 0 0 0 0 0 0 0 0 0 5 35 0 0 0 0 0 0 0 0 0 0 0 0 0 0 0 0 0 0 
0 30 35 0 0 0 0 0 18 0 0 0 0 0 0 0 0 0 0 0 40 0 0 0 0 0 0 0 0 0 0 0 0 0 0 0 0 0 0 0 
2 48 29 0 0 0 0 0 0 0 0 0 0 0 0 0 0 0 0 0 0 0 0 0 0 0 32 32 33 0 0 0 0 0 0 0 0 0 0 0 
0 34 0 0 0 0 0 0 0 0 0 54 0 0 0 0 0 0 0 34 0 0 0 0 0 0 49 0 0 0 0 5 0 0 0 0 0 0 0 0 
0 0 0 0 0 0 0 0 0 0 0 0 0 0 0 0 0 0 0 0 0 0 0 0 0 0 0 0 6 21 47 0 0 0 0 0 0 0 0 0 
0 0 0 0 0 0 0 0 0 0 0 0 0 0 0 0 0 0 0 0 1 37 35 0 0 0 0 0 0 0 0 0 0 0 0 0 0 0 0 0 
0 0 0 0 0 0 0 0 0 54 14 0 0 0 0 0 0 0 0 55 15 34 0 0 0 0 0 0 0 0 0 0 39 0 0 32 0 0 0 0 
0 0 0 0 0 0 0 0 45 0 0 0 0 0 0 0 0 0 0 0 0 0 0 0 0 0 0 0 0 0 0 0 0 42 0 0 27 0 0 0 
0 0 0 0 0 0 0 0 0 0 0 0 0 0 0 0 0 0 0 0 0 0 0 0 0 0 0 0 33 39 0 0 0 0 0 0 0 0 0 0 
0 0 0 0 0 0 0 0 16 0 0 0 0 0 0 54 10 0 0 0 0 0 0 0 15 34 0 0 0 36 0 0 0 0 0 0 0 0 0 0 
0 0 0 0 39 0 0 0 0 0 0 0 0 0 0 0 0 0 0 0 0 0 0 0 0 0 0 0 0 0 0 0 0 0 0 0 0 0 0 0 
0 0 0 0 0 0 0 0 0 0 0 0 0 0 0 0 36 0 0 0 0 38 0 0 0 0 0 0 31 46 0 0 0 0 0 0 0 0 0 0 
0 0 0 0 0 0 0 0 0 0 19 2 33 0 0 0 0 0 0 0 0 30 18 2 0 0 0 0 36 1 0 0 0 57 0 10 0 0 0 0 
0 0 0 0 0 0 0 0 0 0 49 0 8 0 0 0 0 0 0 0 0 36 0 6 50 0 0 0 0 40 0 0 0 0 0 0 0 0 0 0 