14 12 20 12 1 17 0 0 0 0 0 0 0 0 0 0 0 6 21 30 0 0 0 0 0 14 31 27 27 20 18 18 18 31 20 1 10 27 20 25 
4 27 1 20 27 17 0 0 0 0 0 0 0 0 0 0 0 0 0 0 0 0 0 0 0 5 27 1 27 12 27 1 13 13 21 27 1 20 1 17 
12 27 20 20 3 2 30 0 0 0 0 0 0 0 0 0 0 0 0 14 29 0 0 14 31 1 20 27 12 1 12 25 0 0 0 28 12 20 2 26 
23 1 1 12 8 0 0 0 0 0 0 0 0 0 0 0 0 15 32 1 12 31 18 20 12 1 20 1 12 27 12 17 0 0 0 4 20 17 0 0 
14 12 20 12 16 0 0 0 0 0 0 0 0 0 0 0 0 0 0 22 2 2 13 27 12 1 12 20 12 12 20 25 0 0 0 5 20 16 0 0 
5 20 12 12 16 0 0 0 0 0 0 0 0 0 0 0 0 0 0 7 0 0 3 13 13 17 20 27 1 20 27 17 0 0 0 4 1 8 0 0 
28 21 27 12 27 10 29 0 0 0 0 0 0 0 0 0 0 0 0 23 0 0 0 0 0 5 27 20 20 27 1 1 18 6 18 20 20 25 0 0 
21 2 2 12 1 12 8 0 0 0 0 0 0 0 0 0 0 0 0 22 18 29 0 0 0 22 20 13 13 1 1 20 20 20 1 12 12 16 0 0 
0 0 0 5 12 12 25 0 0 0 0 0 0 0 0 0 0 0 0 5 2 13 31 31 31 12 17 0 0 4 12 1 27 12 27 20 21 13 30 0 
0 0 0 4 20 20 8 0 0 0 0 0 0 0 0 0 0 0 14 26 0 0 6 2 21 13 17 0 0 28 13 2 1 27 12 25 0 0 0 0 
0 0 14 12 2 21 1 29 0 0 0 0 0 0 15 11 31 31 17 0 0 0 0 0 0 0 6 11 10 8 0 0 6 20 27 25 0 0 0 0 
0 0 5 8 0 0 5 25 0 0 0 0 0 0 0 0 22 20 16 0 0 0 0 0 0 0 0 0 28 25 0 0 0 5 1 19 29 0 0 0 
0 0 22 25 0 0 4 12 10 29 0 0 0 0 0 0 4 27 1 29 0 0 0 0 0 0 0 0 4 8 0 0 0 22 27 21 21 29 0 0 
0 14 27 21 32 10 20 12 27 12 18 10 31 29 0 0 4 27 12 12 10 10 29 0 0 0 0 0 28 20 30 0 0 4 25 0 0 22 30 0 
0 5 17 0 0 28 20 27 12 1 21 13 20 17 0 0 5 1 12 27 27 1 25 0 0 0 14 10 27 26 0 0 0 5 16 0 0 7 0 0 
11 21 16 0 0 27 1 27 12 25 0 0 6 2 11 11 1 27 27 27 27 25 27 18 10 10 27 12 17 0 0 0 0 5 16 0 0 23 0 0 
0 0 4 18 31 22 12 1 13 26 0 0 0 0 0 0 22 12 20 27 12 27 12 1 20 20 12 27 17 0 0 0 0 22 1 10 10 20 29 0 
0 0 19 27 12 20 20 16 0 0 0 0 0 0 0 0 6 13 1 20 20 20 12 27 27 1 27 27 16 0 0 10 10 12 4 12 1 12 8 0 
0 15 27 27 20 12 20 17 0 0 0 0 0 0 0 0 0 0 6 12 27 1 1 27 1 27 27 1 25 0 0 5 27 27 27 12 12 27 8 0 
0 0 6 27 20 12 20 25 0 0 0 0 0 0 0 0 0 0 0 4 12 27 27 12 1 12 13 21 2 19 10 1 12 12 20 27 1 1 17 0 
0 0 0 4 1 20 27 27 10 19 30 0 0 0 0 0 0 0 0 6 1 1 1 1 27 8 0 0 0 0 22 27 1 1 12 12 1 28 21 11 
0 0 0 22 12 20 27 27 17 0 0 0 15 32 30 0 0 0 0 2 2 12 20 27 27 16 0 0 0 0 4 27 12 12 1 20 27 17 0 0 
0 0 0 28 1 27 12 20 25 0 0 0 0 0 0 0 0 0 0 0 0 22 27 17 1 12 18 10 17 31 20 20 20 12 10 27 27 17 0 0 
0 0 14 12 20 21 2 12 8 0 0 0 0 0 0 0 0 0 0 0 0 5 12 1 1 12 27 12 27 12 27 27 12 1 27 1 1 8 0 0 
0 14 12 12 17 0 0 5 27 29 0 0 0 0 9 0 0 0 0 14 31 20 1 1 20 27 20 1 27 12 1 27 1 27 20 27 20 8 0 0 
0 28 1 20 25 0 0 4 27 8 0 0 0 0 0 0 0 0 0 28 1 21 21 2 21 27 1 12 20 27 20 12 12 20 20 27 1 16 0 0 
0 6 27 27 12 10 10 12 27 20 31 29 0 0 0 0 0 0 18 4 26 0 0 0 0 22 1 1 12 12 20 1 27 20 13 21 2 21 11 30 
0 0 22 20 1 1 1 27 20 27 16 17 0 0 0 0 0 14 20 16 0 0 24 0 0 4 20 20 20 18 25 27 1 16 0 0 0 0 0 0 
0 0 28 20 20 13 2 12 1 1 1 16 0 0 0 0 0 28 1 17 0 0 7 0 0 22 1 27 27 27 27 27 1 8 0 0 0 0 0 24 
0 0 28 27 17 0 0 4 1 1 12 25 0 0 0 0 0 5 20 20 31 18 12 18 10 1 1 1 12 20 20 27 27 27 0 30 0 14 10 16 
0 0 28 12 25 0 0 5 27 12 20 1 18 10 18 18 31 12 27 20 20 27 27 20 12 27 27 1 1 27 1 20 20 17 0 0 0 5 1 27 
32 10 12 20 26 0 0 6 13 1 20 20 20 13 13 2 1 20 20 12 16 20 20 12 20 12 12 1 1 1 12 1 1 20 31 10 32 2 13 0 
0 4 16 26 0 0 0 0 0 6 1 12 16 0 0 0 5 17 22 21 13 12 20 20 20 12 1 27 1 12 1 12 27 21 2 26 0 0 0 0 
0 28 25 0 0 0 0 0 0 0 6 12 17 0 0 0 28 8 0 0 0 28 1 1 4 20 27 27 12 21 13 18 16 0 0 0 0 0 0 0 
10 27 25 0 0 0 0 0 0 0 0 4 16 0 0 0 4 17 0 0 0 5 12 1 12 12 22 20 8 0 0 28 16 0 0 0 0 0 0 0 
28 20 25 0 0 0 0 0 0 0 0 4 12 18 32 19 27 27 18 18 18 12 1 12 1 31 1 20 25 0 0 4 27 29 0 0 0 0 0 0 
5 12 27 18 31 31 10 31 31 31 10 1 20 17 0 0 22 1 1 1 12 27 12 20 21 13 20 20 17 0 0 22 12 27 18 18 29 0 0 13 
28 12 1 4 20 12 27 12 27 20 20 1 1 25 0 0 22 1 12 20 1 27 20 16 0 0 28 1 12 10 10 1 20 27 1 1 20 31 10 4 
4 20 1 1 20 1 12 20 12 1 20 12 27 27 18 18 1 12 27 12 1 27 27 8 0 0 4 12 20 27 27 20 1 27 1 1 12 1 12 8 
5 27 27 21 32 1 2 12 12 20 1 20 1 21 13 2 2 2 20 1 1 1 12 8 0 0 4 1 27 1 13 27 20 21 1 20 13 20 3 8 