11 12 1 27 20 27 27 1 20 20 29 0 0 0 0 15 12 18 1 31 27 27 27 27 20 18 1 1 12 31 10 31 20 27 3 10 20 25 0 0 
0 28 1 27 1 1 1 27 20 20 17 0 0 24 0 0 5 20 12 20 12 20 20 27 12 1 12 12 1 20 1 27 27 27 2 13 20 17 0 0 
0 5 12 1 12 20 20 12 20 1 16 0 0 23 0 0 5 12 12 20 12 12 27 27 1 13 13 2 2 13 21 13 2 26 0 0 6 21 10 29 
31 20 1 27 12 27 1 27 21 2 2 19 19 16 0 0 4 12 1 12 12 20 12 2 26 0 0 0 0 0 0 0 0 0 0 0 0 0 5 27 
20 1 27 12 1 1 1 8 0 0 0 0 0 23 0 0 22 27 1 12 20 12 25 0 0 0 0 0 0 0 0 0 0 0 0 0 0 0 28 16 
8 12 19 27 12 13 21 16 0 0 0 0 0 28 10 31 3 13 2 2 1 1 16 0 0 0 0 0 0 0 0 0 24 0 0 0 0 0 28 5 
12 12 1 1 16 0 0 28 10 10 10 31 18 1 1 17 0 0 0 0 5 20 25 0 0 0 0 0 0 0 0 0 4 31 31 18 18 18 12 25 
22 27 20 27 17 0 0 22 31 27 27 1 27 20 12 25 0 0 0 0 5 27 25 0 0 0 0 0 0 0 0 14 20 20 1 1 1 13 21 11 
27 27 20 27 12 31 18 20 1 27 1 27 13 2 21 2 10 31 12 31 12 1 8 0 0 0 0 0 0 0 14 12 20 20 1 12 25 0 0 18 
20 1 27 13 13 12 20 1 20 20 12 27 25 0 0 0 22 1 1 27 12 21 2 32 11 29 0 0 0 0 4 13 13 21 1 1 26 0 0 0 
6 12 25 0 0 4 20 13 13 20 27 20 8 0 0 0 6 2 27 12 25 0 0 0 0 28 29 0 0 0 7 0 0 0 22 8 0 0 0 0 
0 6 26 0 0 28 8 0 0 28 1 1 8 0 0 0 0 0 25 6 17 0 0 0 0 28 8 0 0 0 23 0 0 0 22 17 0 0 0 0 
0 0 0 0 0 22 8 0 0 28 1 1 25 0 0 0 0 0 0 0 23 0 0 0 15 2 21 11 11 32 13 11 32 18 27 25 0 0 0 0 
0 0 0 0 14 27 17 0 0 22 27 1 17 0 0 0 0 0 0 0 5 31 30 0 0 0 0 0 0 0 0 0 0 4 12 8 0 0 0 0 
0 0 0 14 27 27 27 18 31 20 20 12 16 0 0 0 0 0 0 0 5 8 0 0 0 0 0 0 0 0 0 0 0 4 31 25 0 0 0 0 
0 0 14 27 12 20 20 21 2 2 27 1 8 0 0 0 15 19 18 18 1 16 0 0 0 0 24 0 0 0 0 0 0 28 12 20 31 29 0 0 
0 0 28 1 12 12 25 0 0 0 28 27 8 0 0 0 0 0 22 12 12 17 0 0 0 0 23 0 0 14 10 18 31 20 1 27 12 25 0 0 
0 0 6 12 27 20 25 0 0 0 22 12 25 0 0 0 0 0 28 20 27 17 0 0 0 0 7 0 0 22 20 1 1 12 20 1 1 20 10 31 
4 0 0 6 27 20 16 0 0 0 6 20 8 0 0 0 0 0 4 27 20 27 31 31 27 18 17 0 0 4 1 20 12 20 27 12 12 20 27 27 
30 0 0 0 28 12 25 0 0 0 0 5 20 10 10 10 10 19 21 26 27 1 27 27 12 27 12 31 10 2 13 1 20 20 1 1 12 20 12 1 
20 0 0 0 22 27 8 0 0 0 0 5 20 20 20 27 25 0 0 0 5 12 27 20 20 12 12 20 17 0 0 22 1 12 12 27 1 27 12 8 
20 29 0 14 20 13 2 18 31 31 10 12 16 20 20 20 8 0 0 0 5 12 27 20 27 20 12 1 25 0 0 4 12 27 20 27 12 20 12 17 
4 26 0 28 8 0 0 28 12 12 21 2 21 27 20 27 16 0 0 0 4 1 20 27 12 20 27 1 20 10 31 27 12 27 1 1 27 1 12 12 
5 0 0 4 16 0 0 22 27 25 0 0 0 6 27 12 27 18 31 18 1 27 27 20 20 12 1 1 20 27 27 2 21 27 12 1 1 12 20 20 
17 0 0 28 20 10 31 27 20 16 0 0 0 0 28 27 27 1 1 20 12 1 1 20 20 20 20 20 12 27 25 0 0 22 20 20 27 20 12 18 
27 18 31 20 12 1 12 12 20 17 0 0 0 0 28 20 12 1 20 31 13 27 1 27 23 27 27 20 12 12 8 0 0 28 12 21 12 12 27 26 
27 12 12 27 27 1 27 12 3 20 29 0 0 0 6 27 20 1 25 0 0 28 12 21 2 27 25 27 27 27 17 0 0 5 13 13 2 2 12 20 
8 27 20 12 13 2 21 1 20 20 17 0 0 0 0 5 27 1 25 0 0 28 25 0 0 6 20 12 1 1 27 18 31 17 0 0 0 0 22 8 
4 16 20 8 0 0 0 4 1 27 16 0 0 0 0 28 28 12 8 0 15 13 8 0 0 0 28 1 20 1 12 27 1 16 0 0 0 0 4 25 
12 12 12 25 0 0 0 5 12 1 20 18 31 18 31 20 1 1 8 0 0 0 23 0 0 0 28 12 13 21 27 20 27 12 18 31 11 19 1 25 
4 1 27 16 0 0 0 28 27 20 27 12 20 27 20 20 20 1 25 0 0 0 4 19 11 32 21 26 0 0 4 12 18 20 27 16 0 0 4 17 
28 1 11 21 31 10 10 1 12 27 12 12 27 1 27 12 12 27 25 0 0 14 8 0 0 0 0 0 0 0 5 12 13 1 1 17 0 0 22 16 
4 8 0 0 22 27 20 27 27 20 27 20 12 1 12 27 20 1 12 18 18 20 17 0 0 0 0 14 10 10 21 2 1 20 27 8 0 0 4 8 
1 16 0 0 4 20 27 1 12 20 20 2 13 1 1 1 20 27 1 20 20 27 17 0 0 15 31 27 1 17 0 0 22 27 1 20 10 31 12 17 
4 20 18 31 1 12 21 2 1 20 17 0 0 28 20 20 12 1 20 20 23 20 8 0 0 0 5 27 19 25 0 0 5 27 1 27 20 1 20 12 
21 1 27 20 27 17 0 0 5 20 17 0 0 5 27 20 1 12 21 2 20 20 17 0 0 0 22 12 20 27 10 18 2 13 12 12 12 1 1 2 
17 28 27 12 2 17 0 0 22 20 21 19 10 21 2 13 20 16 0 0 28 20 25 0 0 0 28 12 27 27 1 17 0 0 22 27 21 1 8 0 
0 22 12 12 20 5 31 10 1 16 0 0 7 0 0 0 22 16 0 0 28 21 2 19 30 0 4 13 13 27 27 8 0 0 4 27 12 20 8 0 
0 28 20 1 13 1 1 20 20 16 0 0 23 0 0 0 4 12 31 31 17 0 0 0 0 0 23 0 0 22 17 12 31 10 1 1 8 6 16 0 
0 22 21 1 13 13 13 27 1 2 10 11 26 0 0 0 6 3 20 27 25 0 0 0 0 14 16 0 0 6 20 20 1 13 12 1 1 21 13 19 