4 26 0 0 0 0 0 0 0 0 0 0 0 0 28 1 12 8 0 0 0 22 12 31 25 
26 0 0 0 0 0 0 0 0 0 0 24 0 0 4 27 1 17 0 0 0 22 27 20 8 
0 0 0 0 0 0 0 0 0 0 0 6 32 10 12 20 12 27 31 18 10 10 12 12 17 
0 0 24 0 0 0 0 0 0 0 0 0 0 28 1 12 12 27 1 20 27 1 1 27 25 
19 19 8 0 0 0 0 0 0 0 0 0 0 5 27 12 20 20 27 1 2 21 12 12 25 
0 0 23 0 0 0 0 0 0 0 0 0 0 22 4 20 20 1 20 25 0 0 28 20 25 
0 0 7 0 9 0 0 0 0 0 0 0 0 5 20 12 20 1 1 8 0 0 22 12 20 
7 10 17 0 0 0 0 0 0 0 9 0 0 4 21 21 20 20 20 1 10 31 20 12 2 
2 12 25 0 0 0 0 0 0 0 0 0 0 7 0 0 22 27 27 1 1 12 1 25 0 
0 28 25 0 0 0 0 0 0 14 31 18 18 17 0 0 5 1 27 20 1 12 20 17 0 
0 22 16 0 0 0 14 10 31 27 21 13 20 8 0 0 5 27 1 12 1 1 20 1 20 
14 12 20 10 18 18 12 1 12 8 0 0 28 1 11 32 12 27 20 12 2 2 1 12 27 
22 1 20 2 21 13 20 12 20 25 0 0 5 17 0 0 22 1 20 8 0 0 28 12 25 
22 1 25 0 0 0 4 20 12 8 0 0 28 17 0 0 28 27 27 17 0 0 4 20 12 
1 27 16 0 0 0 28 27 27 17 0 0 4 27 31 18 12 20 1 16 0 0 22 12 17 
28 27 20 11 19 18 1 10 27 16 0 0 4 12 20 12 12 12 27 12 31 18 12 20 17 
22 27 8 0 0 22 27 1 12 1 18 19 2 13 21 21 21 20 12 2 3 2 4 13 20 
18 20 16 0 0 22 27 20 20 27 17 0 0 0 0 0 0 28 16 0 0 0 0 0 24 
22 20 25 0 15 20 20 12 1 20 25 0 0 0 0 0 0 5 8 0 0 0 0 0 6 
28 20 8 0 0 5 12 1 27 12 25 0 0 0 0 0 0 28 1 10 10 18 31 10 29 
27 1 17 0 0 28 12 20 1 27 16 0 0 0 0 0 0 22 1 20 27 13 20 27 25 
21 13 27 31 18 1 12 27 27 12 17 0 0 0 0 0 0 6 20 1 27 21 22 12 11 
0 0 22 1 20 27 12 27 1 1 8 0 0 0 0 0 0 0 6 13 27 31 2 2 16 
0 0 22 20 12 1 11 20 27 1 8 0 0 0 0 0 0 0 0 0 4 16 0 0 23 
11 31 21 20 27 21 27 12 21 12 16 0 0 0 0 0 0 0 0 0 28 25 0 0 6 