0 0 0 0 14 31 18 3 20 27 29 31 20 17 0 0 0 0 14 20 27 30 0 0 0 0 0 14 29 0 0 0 0 0 0 0 0 0 0 0 
0 0 0 0 22 27 32 12 12 20 27 1 1 17 0 0 0 0 4 1 17 0 0 0 0 0 0 5 25 0 0 0 0 0 0 14 30 0 0 0 
0 0 0 14 1 20 20 1 21 2 2 21 13 21 32 19 19 31 27 27 16 0 0 0 0 0 0 6 1 29 0 0 0 0 0 7 0 0 0 0 
0 0 14 27 27 20 27 25 0 0 0 0 0 0 0 0 0 22 20 20 20 10 31 29 0 0 0 0 6 2 32 18 31 18 10 25 0 0 0 0 
0 0 4 27 1 27 1 8 0 0 0 24 0 0 0 0 0 5 12 20 27 20 28 20 29 0 0 0 0 0 0 28 20 1 20 12 31 31 18 19 
10 18 12 2 13 16 13 26 0 0 0 7 16 0 0 0 0 28 12 12 20 20 1 12 8 0 0 14 29 0 0 21 12 20 27 20 20 21 12 22 
8 27 16 0 0 0 0 0 0 0 15 27 25 0 0 0 0 5 12 20 20 1 1 29 12 31 32 13 20 10 18 1 27 20 27 13 13 13 2 21 
21 13 17 0 0 14 29 0 0 0 0 22 27 10 18 2 19 21 21 2 13 21 1 20 27 16 0 0 28 27 1 12 1 1 16 0 0 0 0 0 
0 0 6 32 19 27 17 0 0 0 0 28 27 1 26 0 0 0 0 0 0 0 28 1 27 8 0 0 5 27 20 27 27 20 17 0 0 0 0 0 
0 0 0 0 0 5 27 31 18 10 31 20 1 17 0 0 0 0 0 0 0 0 6 13 21 21 19 31 27 27 27 12 1 20 17 0 0 14 10 31 
0 0 0 0 0 4 12 27 1 20 27 27 20 8 0 0 0 0 0 0 0 0 0 0 0 0 0 4 12 20 3 2 2 12 17 0 0 4 20 20 
15 0 0 0 0 22 12 12 1 12 27 20 20 25 0 0 0 0 0 0 0 0 0 0 0 0 0 4 12 27 8 0 0 4 25 0 0 28 13 26 
0 0 0 0 0 6 20 27 20 1 1 1 20 1 18 18 18 31 10 30 0 0 0 0 14 18 10 12 20 1 16 0 0 4 27 18 10 8 0 0 
0 0 0 0 0 0 6 12 12 1 27 27 1 27 20 20 17 12 16 0 0 0 0 0 28 2 21 12 27 20 27 18 10 1 1 1 12 26 0 0 
0 0 24 0 0 0 0 6 20 20 18 12 27 20 27 1 12 1 16 0 0 0 14 10 16 0 0 4 27 1 1 20 12 12 20 20 8 0 0 0 
0 0 5 29 0 0 0 0 5 1 12 20 12 12 12 12 1 1 27 29 0 0 4 1 8 0 0 5 27 1 20 27 20 27 12 20 10 0 0 0 
14 18 1 8 0 0 0 0 4 21 21 21 21 13 1 12 12 1 27 20 31 10 2 2 2 31 31 20 12 1 27 27 12 20 1 12 25 0 0 0 
28 12 1 16 0 0 0 14 25 0 0 0 0 0 4 20 1 1 1 21 2 26 0 0 0 4 2 27 12 27 12 1 20 1 13 21 16 0 0 14 
1 21 2 13 29 0 0 28 16 0 0 0 0 0 4 27 1 12 25 0 0 0 0 0 0 5 27 20 27 1 20 1 18 8 0 0 6 31 18 15 
23 0 0 0 5 31 31 12 8 0 0 0 0 14 27 1 27 1 25 0 0 0 0 0 0 28 12 12 20 20 12 27 20 17 0 0 0 4 12 27 
8 0 0 0 28 1 22 20 17 0 0 0 0 22 12 12 27 20 25 0 0 14 29 0 14 1 12 1 13 13 13 13 27 20 29 0 0 6 27 20 
20 19 11 32 27 27 21 2 13 32 30 0 14 1 27 1 12 1 20 31 10 1 8 0 6 13 27 8 0 0 0 0 28 20 8 0 0 0 28 1 
26 0 0 0 22 25 0 0 0 0 0 0 5 27 1 20 20 12 1 27 27 11 8 0 0 0 6 8 0 0 0 0 28 1 8 0 0 0 5 16 
0 0 0 0 28 17 0 0 0 0 0 0 22 21 13 20 1 12 12 20 20 12 12 29 0 0 0 5 18 10 10 18 27 27 25 0 0 0 22 2 
0 0 0 0 22 12 18 31 31 31 18 10 17 0 0 4 27 27 12 12 12 12 27 8 0 0 0 5 20 20 12 1 12 12 8 0 0 0 7 0 
0 0 0 14 27 27 1 1 27 2 13 12 17 0 0 5 20 2 2 27 27 1 20 20 29 0 0 5 20 27 1 20 20 1 16 0 0 0 7 0 
0 0 0 4 1 20 12 1 26 0 0 4 1 30 0 28 8 0 0 4 1 12 12 20 16 0 0 5 27 27 27 27 8 1 25 0 0 0 7 0 
15 10 11 2 1 20 27 16 0 0 0 4 16 0 0 5 16 0 0 22 12 1 20 27 17 0 0 28 27 20 27 27 12 27 12 30 0 0 7 0 
0 7 0 0 28 27 20 17 0 0 14 20 17 0 0 4 20 31 10 1 12 20 12 12 8 0 0 4 12 12 12 1 12 21 17 0 0 0 23 0 
0 23 0 0 4 27 27 1 31 3 20 20 20 31 18 27 12 27 1 12 12 12 12 27 25 0 0 5 27 20 20 27 13 2 25 0 0 0 6 11 
10 20 31 10 1 20 27 12 12 21 21 2 12 1 27 27 27 1 20 20 12 20 27 20 1 32 11 2 1 20 1 25 0 0 22 29 0 0 0 0 
22 1 1 20 20 12 12 27 25 0 0 0 28 1 27 20 2 21 4 16 12 27 1 1 17 0 0 0 22 20 12 8 0 0 4 25 0 0 0 0 
5 20 20 12 27 1 20 20 16 0 0 0 5 20 12 16 0 0 28 12 12 20 20 12 8 0 0 0 4 12 12 2 19 31 12 21 19 19 29 12 
1 27 27 12 1 20 20 27 27 31 31 10 1 20 27 8 0 0 4 27 20 27 1 27 12 18 11 11 20 12 8 0 0 5 25 0 0 0 4 29 
12 1 27 27 12 27 21 2 13 2 21 12 1 20 20 25 0 0 22 11 1 20 27 20 1 17 0 0 6 13 17 0 0 5 17 0 0 0 5 20 
29 21 13 3 27 16 0 0 0 0 0 5 20 1 27 20 31 10 13 2 13 12 1 12 27 25 0 0 0 0 4 31 31 27 1 31 18 10 20 27 
27 0 0 22 1 26 0 0 0 0 0 5 20 12 27 1 27 17 0 0 0 28 27 13 21 16 0 0 0 0 28 12 12 12 20 12 27 27 12 17 
7 0 0 4 16 0 0 0 0 0 0 22 13 2 21 13 1 8 0 0 0 5 17 0 0 22 29 0 0 0 28 12 1 20 12 1 27 1 20 20 
28 31 31 20 8 0 0 0 0 0 0 23 0 0 0 0 4 25 0 0 0 5 16 0 0 7 1 10 10 18 12 12 20 20 1 1 12 27 12 23 
28 1 12 2 17 0 0 0 0 0 0 23 0 0 0 0 28 18 0 0 0 6 2 10 32 1 27 2 20 13 1 2 21 1 12 13 27 20 1 12 